"","X","idtorrent","category","size","seeders","leechers","group","peers","diff","title"
"1",563761,4553904,501,738407232,18,100,"porn",118,82,"Asian POV #6 [2008, DVD.xvid]"
"2",563763,4553889,501,1481763712,8,142,"porn",150,134,"Evil Angel: Fresh Meat #25 [2008, DVD.xvid]  - anal, gonzo"
"3",563764,4553878,599,1043626752,72,713,"porn",785,641,"Felony Foreplay  - Big tit redhead MILF (HD: 1280 x 720)"
"4",563773,4553739,599,514850816,3,484,"porn",487,481,"MILFs Like It Big - Lisa Ann, Sophia Lomeli & Julia Ann"
"5",563776,4553658,599,737694208,44,493,"porn",537,449,"Sexy Bitch [2008, DVDrip.xvid]"
"6",563782,4553492,501,731056704,34,246,"porn",280,212,"Summer.School.Sex.Kittens.XXX.DVDRip.XviD"
"7",563784,4553457,501,1170378624,2,116,"porn",118,114,"Not found"
"8",563786,4553429,501,581424896,136,268,"porn",404,132,"InTheVip - Freaks cum out at nite"
"9",563787,4553427,506,195433600,44,89,"porn",133,45,"Not found"
"10",563788,4553419,501,708900288,61,84,"porn",145,23,"Superstition (1999, DVDrip) - anal,DP"
"11",563789,4553408,501,746533696,52,185,"porn",237,133,"Daring! Simply Beautiful  [2008] - anal, DP, Regina Ice, Cristin"
"12",563790,4553400,501,1642824960,48,318,"porn",366,270,"Marc Dorcel - Ass And Lace [DVD.xvid] - anal, lingerie"
"13",563791,4553397,506,640658944,25,168,"porn",193,143,"Not found"
"14",563792,4553385,506,569072704,58,130,"porn",188,72,"Not found"
"15",563794,4553360,501,732388416,26,752,"porn",778,726,"Not found"
"16",563795,4553325,501,1471026304,1,419,"porn",420,418,"Not found"
"17",563796,4553316,599,585325632,169,912,"porn",1081,743,"I am God! - Momomi & Ran (lolita, redhead)"
"18",563797,4553298,501,733908800,50,158,"porn",208,108,"Street Blowjobs.avi"
"19",563798,4553294,501,1406601728,21,105,"porn",126,84,"Not found"
"20",563799,4553262,501,1460288896,11,108,"porn",119,97,"Not found"
"21",563802,4553247,501,1460288896,16,101,"porn",117,85,"Not found"
"22",563804,4553238,501,730815552,252,1066,"porn",1318,814,"Tora Tora Gold Vol.12 : Mariko (anal toying, beads, 90cm).avi"
"23",563806,4553210,501,1567663104,9,112,"porn",121,103,"Not found"
"24",563834,4553129,501,942281856,43,95,"porn",138,52,"Not found"
"25",563839,4552966,506,425963040,78,100,"porn",178,22,"Not found"
"26",563840,4552949,501,900380736,38,85,"porn",123,47,"Not found"
"27",563842,4552759,501,1460288896,1,126,"porn",127,125,"Not found"
"28",563848,4552504,501,849336064,1,143,"porn",144,142,"Sexxxy - Mamae Fiz Porno"
"29",563849,4552450,501,725205632,107,151,"porn",258,44,"Not found"
"30",563850,4552398,501,1492501120,23,257,"porn",280,234,"Seventeen - Teeny Classics 5 [2008, DVD.xvid]"
"31",563853,4552318,599,387710976,341,1765,"porn",2106,1424,"SkyAngel Blue Vol.2 - Serina (slim, model-like brunette teen)"
"32",563856,4552188,599,477626368,212,603,"porn",815,391,"Kokeshi Cowgirl Vol.16 Misaki (SM, ropes, candlewax)"
"33",563857,4552158,501,740053504,83,198,"porn",281,115,"Not found"
"34",563859,4552145,501,1471026304,35,179,"porn",214,144,"Not found"
"35",563860,4552134,501,1599875328,43,215,"porn",258,172,"Not found"
"36",563861,4552127,501,742580544,79,190,"porn",269,111,"Not found"
"37",563864,4552104,501,1471026304,48,140,"porn",188,92,"Not found"
"38",563865,4552093,501,742433728,50,78,"porn",128,28,"Not found"
"39",563868,4552076,501,737998272,33,94,"porn",127,61,"Not found"
"40",563869,4552053,501,726883392,1,545,"porn",546,544,"When Vivid Girls Go Anal"
"41",563870,4552041,501,1664299776,22,92,"porn",114,70,"Cyber Update Des. 2008----WP-5886 Bobbi  Tia. Mp4  torrent +"
"42",563871,4552002,505,941631744,33,75,"porn",108,42,"DDF Simony & Zafira houseoftaboo.com 2008 HDV + photoset"
"43",563873,4551943,599,1471026304,44,530,"porn",574,486,"French X - Blanche, Alice, Sandy et les autres [2008] - anal,DP,"
"44",563883,4551877,501,739927680,63,99,"porn",162,36,"Not found"
"45",563894,4551861,501,1471026304,111,279,"porn",390,168,"Not found"
"46",563904,4551845,501,718673024,156,641,"porn",797,485,"Classic: Dirty Girls (1984) - Anal, DP, DPP, peeing"
"47",563908,4551836,501,254174816,124,96,"porn",220,-28,"Not found"
"48",563909,4551835,501,271277088,1,120,"porn",121,119,"ExploitedTeens - Anastasia.mpg"
"49",563915,4551813,501,1481763712,103,306,"porn",409,203,"Not found"
"50",563916,4551806,501,1009222912,46,104,"porn",150,58,"Not found"
"51",563918,4551792,501,451674112,77,76,"porn",153,-1,"Not found"
"52",563919,4551790,501,723758592,118,486,"porn",604,368,"French amateur X - SacrÃ©es Coquines #16 [DVD.xvid]"
"53",563920,4551785,501,734946944,195,348,"porn",543,153,"Not found"
"54",563921,4551777,504,2641404928,58,133,"porn",191,75,"[HentaiShare].Their.Styles"
"55",563922,4551769,501,332482464,112,145,"porn",257,33,"Not found"
"56",563924,4551698,501,733531328,143,657,"porn",800,514,"Tora Tora Gold Vol.11 : Ami (maid, nurse, clothed sex).avi"
"57",563926,4551688,501,1471026304,48,367,"porn",415,319,"Real Wife Stories 2 XXX [DVDRip] [Mature]"
"58",563928,4551659,506,344058752,65,82,"porn",147,17,"TeenSexMania - Megan (busty)"
"59",563930,4551622,501,1471026304,53,362,"porn",415,309,"Shemale - T Girl Fantasies Vol. 13 [2008, DVD.xvid]"
"60",563931,4551611,506,194196272,48,73,"porn",121,25,"Not found"
"61",563933,4551601,501,1471026304,65,304,"porn",369,239,"Not found"
"62",563934,4551593,506,164710320,59,44,"porn",103,-15,"Not found"
"63",563938,4551516,599,1921997824,30,125,"porn",155,95,"SeeMyGf.com.XXX[SiteRip-08.12.03][GoldenPirates]"
"64",563943,4551455,501,1460288896,42,264,"porn",306,222,"Private 6 Nurses Take It Up The Ass XXX [DVDRip] [Fetish]"
"65",563947,4551416,501,382069632,50,61,"porn",111,11,"NewCyber Pissing.com-----Coffee Brown-5933"
"66",563949,4551396,599,463533504,232,974,"porn",1206,742,"Kamikaze Girls Vol. 32 : Yukari  (small tits, bondage, gangbang)"
"67",563950,4551363,501,1460288896,41,133,"porn",174,92,"Not found"
"68",563951,4551354,501,1471026304,32,313,"porn",345,281,"Not found"
"69",563953,4551346,501,1460288896,35,71,"porn",106,36,"Not found"
"70",563956,4551329,501,737536896,1,112,"porn",113,111,"Not found"
"71",563957,4551325,501,1245540480,45,172,"porn",217,127,"Not found"
"72",563958,4551317,501,565612352,41,65,"porn",106,24,"Not found"
"73",563959,4551313,501,395082464,32,71,"porn",103,39,"Not found"
"74",563960,4551309,501,342076960,50,55,"porn",105,5,"Not found"
"75",563961,4551292,501,1760936576,39,161,"porn",200,122,"Not found"
"76",563965,4551277,501,1460288896,27,291,"porn",318,264,"Not found"
"77",563966,4551274,501,1460288896,9,150,"porn",159,141,"Not found"
"78",563967,4551273,501,1460288896,33,210,"porn",243,177,"Not found"
"79",563968,4551198,501,663360640,142,366,"porn",508,224,"Not found"
"80",563969,4551190,501,1170378624,131,113,"porn",244,-18,"Gay - SaggerzSkaterz-Skater Beatdowns-Boys Spanking Boys Vol. 6"
"81",563971,4551150,501,1492501120,31,274,"porn",305,243,"Roccos.Animal.Trainer.26.XXX.DVDRiP.XviD-DivXfacTory"
"82",563972,4551139,501,1492501120,14,177,"porn",191,163,"Not found"
"83",563973,4551134,501,1481763712,2,160,"porn",162,158,"Not found"
"84",563974,4551132,501,1481763712,2,104,"porn",106,102,"Not found"
"85",563975,4551128,501,729179776,48,55,"porn",103,7,"Shot.At.Home.7.XXX.DVDRip.XviD-Pr0nStarS"
"86",563976,4551122,501,1471026304,2,123,"porn",125,121,"Not found"
"87",563977,4551116,501,738952448,34,127,"porn",161,93,"Not found"
"88",563979,4551113,501,1471026304,2,106,"porn",108,104,"Not found"
"89",563980,4551111,503,64487424,93,56,"porn",149,-37,"Not found"
"90",563984,4551107,501,1481763712,1,185,"porn",186,184,"Not found"
"91",563987,4551062,501,1471026304,32,102,"porn",134,70,"The Little Black Book Of She-Males (2008)"
"92",563990,4551042,501,1471026304,119,445,"porn",564,326,"Addicted Vol. 5 [2008, DVD.xvid] - Ashlynn Brooke, Audrey Bitoni"
"93",563991,4551038,501,1503238528,193,569,"porn",762,376,"Seventeen - Summertime #2 [DVD.xvid] - anal, outdoors"
"94",563992,4551025,501,1535450752,235,905,"porn",1140,670,"Seventeen - Sweethearts Special - Ballet [2008] - 14 sexy young"
"95",563993,4551021,501,1503238528,132,434,"porn",566,302,"Seventeen - Playground 7 [2008, DVD.Xvid] - outdoors, Euro, teen"
"96",563996,4550972,501,794411648,28,116,"porn",144,88,"Not found"
"97",564001,4550925,501,1481763712,60,175,"porn",235,115,"Minority r u le s  #4  [2008] - Asian, ebony, latina, interracia"
"98",564002,4550918,599,844323904,30,103,"porn",133,73,"Not found"
"99",564003,4550917,501,741448064,188,315,"porn",503,127,"Sexy Bitch [2008] - Mikayla Mendez,Carmella Bing,Alektra Blue,To"
"100",564004,4550913,501,2920577792,71,283,"porn",354,212,"Big Titty Woman #2 + Young Ripe Mellons #4 [DVD.xvid]"
"101",564005,4550908,501,1471026304,104,247,"porn",351,143,"Not found"
"102",564006,4550907,501,1460288896,183,1132,"porn",1315,949,"Not found"
"103",564007,4550876,501,732577152,28,89,"porn",117,61,"Seymore Buttsasamatic.avi"
"104",564022,4550607,506,213783680,3,202,"porn",205,199,"Abby Winters - Nadine & Theresa part 2"
"105",564023,4550593,506,187265184,2,217,"porn",219,215,"Abby Winters - Nadine & Theresa part 1"
"106",564029,4550268,501,1449551488,11,100,"porn",111,89,"[JP] Secretary Bandage"
"107",564032,4550120,501,734286336,26,77,"porn",103,51,"Not found"
"108",564033,4550101,501,340126592,52,85,"porn",137,33,"Naughty America Appreciative Apprentice"
"109",564034,4550088,501,732388416,37,186,"porn",223,149,"Not found"
"110",564036,4550054,503,58573456,67,42,"porn",109,-25,"Not found"
"111",564037,4550049,501,1492501120,84,286,"porn",370,202,"Not found"
"112",564039,4550021,501,720654848,169,220,"porn",389,51,"Not found"
"113",564040,4549973,501,433009472,58,100,"porn",158,42,"Not found"
"114",564041,4549971,501,270469696,73,62,"porn",135,-11,"Not found"
"115",564042,4549961,501,313052352,64,52,"porn",116,-12,"Not found"
"116",564043,4549953,501,367095968,67,58,"porn",125,-9,"Not found"
"117",564044,4549950,501,574368000,75,123,"porn",198,48,"Not found"
"118",564045,4549947,501,446536096,67,102,"porn",169,35,"Not found"
"119",564047,4549881,501,1471026304,60,143,"porn",203,83,"Not found"
"120",564075,4549681,501,731968960,40,64,"porn",104,24,"Ajlawju PL [1999]"
"121",564078,4549575,501,1471026304,164,493,"porn",657,329,"Not found"
"122",564082,4549465,599,1037796608,41,128,"porn",169,87,"Premium: Harem of Amazones (Anna, Honoka & Karen)"
"123",564084,4549457,501,733877376,52,113,"porn",165,61,"Vulvapalooza[2006]DvDrip-Perlite"
"124",564090,4549215,599,347540032,255,1124,"porn",1379,869,"Tokyo Hot n0137 - Cumcum"
"125",564091,4549214,501,214727392,95,84,"porn",179,-11,"Not found"
"126",564092,4549206,501,1492501120,104,264,"porn",368,160,"Not found"
"127",564094,4549183,501,1481763712,91,232,"porn",323,141,"Not found"
"128",564095,4549180,501,1460288896,196,1319,"porn",1515,1123,"Not found"
"129",564096,4549174,501,1460288896,3,1575,"porn",1578,1572,"Not found"
"130",564097,4549171,501,749742336,62,77,"porn",139,15,"Not found"
"131",564100,4549159,501,1481763712,57,137,"porn",194,80,"Not found"
"132",564101,4549155,501,1471026304,32,99,"porn",131,67,"Not found"
"133",564102,4549149,599,555483136,122,825,"porn",947,703,"Red Hot Jam Vol.7 - Eros Note (Mizuki & Emiri)"
"134",564104,4549140,599,843705216,19,92,"porn",111,73,"Not found"
"135",564106,4549126,501,1481763712,63,221,"porn",284,158,"Not found"
"136",564107,4549120,501,1481763712,43,171,"porn",214,128,"Not found"
"137",564108,4549103,501,1449551488,45,100,"porn",145,55,"Not found"
"138",564110,4549068,501,740976256,40,77,"porn",117,37,"Not found"
"139",564111,4549050,501,1385126912,84,428,"porn",512,344,"Not found"
"140",564112,4549034,501,1072116544,44,86,"porn",130,42,"Not found"
"141",564113,4549017,501,999104192,33,79,"porn",112,46,"Not found"
"142",564114,4549012,506,567206208,47,93,"porn",140,46,"Not found"
"143",564115,4549006,506,175227536,93,168,"porn",261,75,"Not found"
"144",564116,4548996,599,736897280,214,932,"porn",1146,718,"Mugen Vol.30 : Sara (Nov. 2008) - bondage, oil"
"145",564117,4548989,506,298015776,73,172,"porn",245,99,"Not found"
"146",564118,4548980,506,267984576,53,81,"porn",134,28,"Not found"
"147",564119,4548967,501,1471026304,104,371,"porn",475,267,"Not found"
"148",564120,4548966,506,70579648,184,173,"porn",357,-11,"Not found"
"149",564121,4548963,506,36888904,52,78,"porn",130,26,"Not found"
"150",564123,4548954,506,58751712,58,69,"porn",127,11,"Not found"
"151",564124,4548951,506,98387888,138,181,"porn",319,43,"Not found"
"152",564125,4548945,506,98912176,75,62,"porn",137,-13,"Not found"
"153",564127,4548932,501,1471026304,30,163,"porn",193,133,"Not found"
"154",564130,4548903,506,161973536,50,63,"porn",113,13,"Infernal Restraint-----Cherry Torn  - Special delivery.rm"
"155",564132,4548894,501,1460288896,29,96,"porn",125,67,"Not found"
"156",564133,4548889,501,1471026304,28,78,"porn",106,50,"Not found"
"157",564135,4548884,599,672881728,37,114,"porn",151,77,"Fetish World - Asian BBW (uncensored).avi"
"158",564136,4548882,501,957874176,23,89,"porn",112,66,"The.Deep.Splash.Lesbians[DvDrip]-Perlite"
"159",564137,4548880,501,1471026304,43,150,"porn",193,107,"Not found"
"160",564138,4548876,501,543277696,64,101,"porn",165,37,"Cyber Update Des. 2008------HT_5492_Kylie Ireland.wmv"
"161",564139,4548864,501,1460288896,1,186,"porn",187,185,"Not found"
"162",564140,4548842,501,1481763712,36,228,"porn",264,192,"Not found"
"163",564141,4548837,501,1471026304,62,186,"porn",248,124,"Transsexual Babysitters 7 (2008)"
"164",564143,4548823,501,1481763712,11,96,"porn",107,85,"Not found"
"165",564144,4548809,501,1471026304,21,110,"porn",131,89,"Not found"
"166",564145,4548805,501,1578400512,73,295,"porn",368,222,"School Girls 2 [2008] - anal, DP, Lucie Theodorova"
"167",564146,4548795,501,1471026304,29,162,"porn",191,133,"Not found"
"168",564148,4548762,501,647527168,91,230,"porn",321,139,"Not found"
"169",564150,4548752,503,27976008,94,53,"porn",147,-41,"Not found"
"170",564151,4548748,501,1471026304,21,186,"porn",207,165,"Not found"
"171",564152,4548747,501,2190433280,23,199,"porn",222,176,"Not found"
"172",564153,4548746,501,1460288896,42,218,"porn",260,176,"Not found"
"173",564154,4548723,599,5175435776,39,476,"porn",515,437,"Evolution - Working Woman 17-18-19-20 (JAV).avi"
"174",564155,4548705,501,374991744,4,258,"porn",262,254,"Abby Winters - Miranda & Stephanie"
"175",564156,4548687,501,236904768,82,327,"porn",409,245,"XVN - Rin Tokiwa (slim/skinny)"
"176",564157,4548677,501,338018944,24,103,"porn",127,79,"Not found"
"177",564158,4548642,599,556363968,177,900,"porn",1077,723,"Kamikaze Premium Vol. 30 : RIN (petite)"
"178",564160,4548587,501,1213328256,1,118,"porn",119,117,"Massage #177 Porn #108 DLEP-003-03 Asia Saloon Woman"
"179",564162,4548563,501,1471026304,43,98,"porn",141,55,"Not found"
"180",564163,4548557,501,1460288896,63,168,"porn",231,105,"Not found"
"181",564165,4548541,501,520471168,53,95,"porn",148,42,"Not found"
"182",564166,4548539,501,1481763712,114,304,"porn",418,190,"MILF Next Door # 5 [2008, DVD.xvid]"
"183",564167,4548535,501,1481763712,158,480,"porn",638,322,"Bring`Um Young Vol. 28 [2008, DVD.xvid]"
"184",564168,4548533,501,1492501120,171,378,"porn",549,207,"Seventeen (17): My Sexy Kittens #40 [2008, DVD.xvid]"
"185",564169,4548532,501,371384640,43,95,"porn",138,52,"Not found"
"186",564170,4548531,501,447521760,48,88,"porn",136,40,"Not found"
"187",564176,4548504,501,1975684992,11,142,"porn",153,131,"[JP] Torturing Female Spy & Detective"
"188",564181,4548480,599,321325632,267,822,"porn",1089,555,"Kamikaze Premium Vol. 24 : Yumi  (shaved pussy)"
"189",564183,4548443,599,738942016,18,115,"porn",133,97,"Jesse Jane - HEAT [2008, DVD.xvid] Kiki Vidis,Madison Scott,Pari"
"190",564184,4548404,599,1449551488,37,333,"porn",370,296,"Jenna Jameson Is Crazy Hot [2008] - Rocco Siffredi"
"191",564186,4548383,599,738103104,139,633,"porn",772,494,"Marc Dorcel - Les Femmes de Luxe [2008, DVD.xvid]"
"192",564187,4548382,506,264796896,56,88,"porn",144,32,"Milf amateur Vesna"
"193",564189,4548357,501,946329344,35,102,"porn",137,67,"Not found"
"194",564192,4548329,506,277977504,138,347,"porn",485,209,"Not found"
"195",564193,4548326,506,236485344,124,411,"porn",535,287,"Not found"
"196",564194,4548321,506,113560784,189,445,"porn",634,256,"Not found"
"197",564195,4548295,501,1471026304,144,909,"porn",1053,765,"Not found"
"198",564196,4548294,501,1460288896,84,664,"porn",748,580,"Not found"
"199",564197,4548280,501,1460288896,38,176,"porn",214,138,"Cum Swapping Girlfriends [2008] - with TAYLOR RAIN !, anal, gonz"
"200",564198,4548257,506,124486944,49,74,"porn",123,25,"Keeley Hazel Sex Tape RED DEVIL"
"201",564199,4548254,501,736561728,53,55,"porn",108,2,"Throat Fuck Gangbang #10 [2008] - deepthroat, gagging, rough"
"202",564200,4548201,506,397955552,37,82,"porn",119,45,"Not found"
"203",564213,4548169,501,694167808,39,155,"porn",194,116,"Nude Exhibitionist Exposure.avi"
"204",564216,4548159,501,1051910464,50,144,"porn",194,94,"Sleepless Nights 1984.avi"
"205",564222,4548055,501,1481763712,154,436,"porn",590,282,"Not found"
"206",564223,4548053,501,1471026304,146,343,"porn",489,197,"Not found"
"207",564224,4548049,501,1471026304,138,403,"porn",541,265,"Not found"
"208",564225,4548045,501,1471026304,128,358,"porn",486,230,"Not found"
"209",564226,4548036,501,745317312,114,197,"porn",311,83,"Not found"
"210",564233,4547839,501,733059456,94,232,"porn",326,138,"Blood Lake XXX (2006) DVD RIP"
"211",564234,4547821,504,1707249536,107,237,"porn",344,130,"[HentaiShare].Oppai.No.Ouja.48"
"212",564235,4547781,501,1460288896,25,89,"porn",114,64,"On The Road Brazil XXX [DVDRIP][Gonzo][blogsexcetera.blogspot.co"
"213",564236,4547778,599,799696512,20,92,"porn",112,72,"I Want Your Cock in my Ass"
"214",564237,4547731,501,1277752832,29,127,"porn",156,98,"Not found"
"215",564238,4547723,501,1277752832,19,108,"porn",127,89,"Not found"
"216",564239,4547719,501,1267015296,16,102,"porn",118,86,"Not found"
"217",564240,4547716,501,1277752832,25,148,"porn",173,123,"Not found"
"218",564241,4547705,501,2931315200,12,121,"porn",133,109,"2 In The Stink.com  Entire Site RIP! (Tigerdirect)"
"219",564242,4547699,501,1116691456,44,191,"porn",235,147,"GGG Betty die-schluckweltmeisterin"
"220",564246,4547600,501,4337916928,25,100,"porn",125,75,"Cum Swapping Cheerleaders  Entire Site RIP (tigerdirect)"
"221",564250,4547593,501,466071072,28,88,"porn",116,60,"Gwen Media - Isabellas toy"
"222",564252,4547591,506,201431456,54,85,"porn",139,31,"Not found"
"223",564253,4547527,506,270176096,27,121,"porn",148,94,"funny.mpg"
"224",564254,4547515,501,423792480,52,123,"porn",175,71,"Not found"
"225",564255,4547512,501,291011296,107,175,"porn",282,68,"Not found"
"226",564258,4547503,501,366886272,57,68,"porn",125,11,"Not found"
"227",564259,4547500,501,513372320,35,90,"porn",125,55,"Not found"
"228",564261,4547493,501,354271872,37,76,"porn",113,39,"Not found"
"229",564297,4547191,501,2780991232,25,194,"porn",219,169,"Not found"
"230",564299,4547178,501,1471026304,53,170,"porn",223,117,"Made.In.Brazil[2008]DvDrip-Perlite"
"231",564301,4547172,501,1234803072,38,194,"porn",232,156,"Not found"
"232",564302,4547166,501,1471026304,29,118,"porn",147,89,"Not found"
"233",564303,4547157,501,1352914688,25,196,"porn",221,171,"Not found"
"234",564305,4547091,501,733405504,41,110,"porn",151,69,"Kamikaze Premium Vol. 28 : Black Jesus (DVD.xvid)"
"235",564306,4547082,501,1428076672,46,356,"porn",402,310,"Not found"
"236",564307,4547050,503,740168832,63,81,"porn",144,18,"[Met-Art] Jenya D Flavor [S7nt4x]"
"237",564308,4547049,506,807414016,51,81,"porn",132,30,"[Met-Art] Capri Anderson Presenting [VID] [S7nt4x]"
"238",564309,4547043,501,802821248,1,114,"porn",115,113,"Not found"
"239",564310,4547007,501,736477824,114,337,"porn",451,223,"Not found"
"240",564312,4546990,501,858626432,172,437,"porn",609,265,"Not found"
"241",564313,4546968,501,733772544,165,310,"porn",475,145,"Tora-Tora Gold Vol.3 : Yui (teen maid, clothed sex).avi"
"242",564314,4546963,506,246950128,194,192,"porn",386,-2,"Not found"
"243",564318,4546939,501,728036800,169,286,"porn",455,117,"Not found"
"244",564321,4546914,501,1471026304,38,214,"porn",252,176,"Shemale - She`s Got Balls [2008, DVD.xvid] - 6 ballsy she-males"
"245",564324,4546844,503,684583808,52,125,"porn",177,73,"sandy summers sets 141-150"
"246",564327,4546817,501,1481763712,166,310,"porn",476,144,"Not found"
"247",564328,4546816,501,1148903808,60,135,"porn",195,75,"Milk.My.Teeny.Titties[2004]DvDrip-Perlite"
"248",564330,4546806,501,863890304,29,97,"porn",126,68,"Not found"
"249",564331,4546805,501,2254857728,52,377,"porn",429,325,"Not found"
"250",564334,4546778,599,727166464,56,104,"porn",160,48,"Not found"
"251",564335,4546702,501,705733568,65,262,"porn",327,197,"Not found"
"252",564337,4546685,501,1460288896,261,1105,"porn",1366,844,"Not found"
"253",564338,4546682,501,1460288896,463,2097,"porn",2560,1634,"Not found"
"254",564339,4546640,501,745673856,85,102,"porn",187,17,"The Training of O-----TTOO-5348  Sabrina Fox day 04.wmv"
"255",564342,4546578,501,296453408,64,51,"porn",115,-13,"Fuckedandbound-----255- Maria Bellucci-Kurt Lockwood"
"256",564346,4546457,599,61131980,102,28,"porn",130,-74,"Not found"
"257",564347,4546422,599,281280512,38,106,"porn",144,68,"Kendo Fuck : Ai  (2006) - martial arts, petite, uncensored"
"258",564351,4546384,599,439311392,137,432,"porn",569,295,"Marc Dorcel - La Soubrette (2005) The French Maid/La Domestica"
"259",564352,4546349,501,962582272,58,104,"porn",162,46,"Passion Pit (1984).mpg"
"260",564353,4546344,599,245345808,83,66,"porn",149,-17,"Midgets Tiny Twats.avi"
"261",564355,4546291,501,1471026304,101,483,"porn",584,382,"Not found"
"262",564356,4546290,501,1471026304,49,314,"porn",363,265,"Not found"
"263",564357,4546287,501,1460288896,63,242,"porn",305,179,"Not found"
"264",564358,4546283,599,315359232,164,591,"porn",755,427,"Kamikaze Premium Vol. 23 : Natsumi  (lolita)"
"265",564359,4546258,501,2190433280,67,553,"porn",620,486,"Not found"
"266",564360,4546203,501,1481763712,50,147,"porn",197,97,"Not found"
"267",564362,4546199,501,1471026304,35,73,"porn",108,38,"Not found"
"268",564363,4546194,501,1492501120,66,74,"porn",140,8,"Not found"
"269",564364,4546192,501,1471026304,28,147,"porn",175,119,"Not found"
"270",564365,4546160,501,940404928,96,301,"porn",397,205,"Not found"
"271",564367,4546085,506,290361184,90,72,"porn",162,-18,"Not found"
"272",564368,4546080,506,696915072,33,75,"porn",108,42,"Not found"
"273",564369,4546074,501,1460288896,34,89,"porn",123,55,"Not found"
"274",564370,4546071,506,289438432,69,53,"porn",122,-16,"Not found"
"275",564371,4546065,506,163703680,71,77,"porn",148,6,"Not found"
"276",564372,4546054,506,375369248,113,240,"porn",353,127,"Not found"
"277",564373,4546047,506,213332784,38,72,"porn",110,34,"Not found"
"278",564382,4545878,501,641193728,20,84,"porn",104,64,"Not found"
"279",564385,4545733,501,388738592,69,64,"porn",133,-5,"Not found"
"280",564404,4545651,501,432369824,46,96,"porn",142,50,"Not found"
"281",564413,4545592,503,1492501120,55,114,"porn",169,59,"Abby Winters Letter C (7827 pictures)"
"282",564422,4545470,501,1567663104,23,91,"porn",114,68,"World Sex Tour - Vol 21.avi"
"283",564430,4545285,501,743807360,184,267,"porn",451,83,"Not found"
"284",564431,4545272,506,415854752,89,66,"porn",155,-23,"Not found"
"285",564432,4545267,501,13604308992,16,112,"porn",128,96,"Not found"
"286",564434,4545263,501,722846336,67,39,"porn",106,-28,"Wifeswitch 5 (Milf Swinger XXX) DVD.RIP XviD"
"287",564436,4545249,501,742014336,133,135,"porn",268,2,"Not found"
"288",564444,4545172,501,1449551488,80,299,"porn",379,219,"Nymphomaniac [2008] - Bobbi Star, new anal Queen of porn"
"289",564452,4545056,501,1481763712,33,92,"porn",125,59,"Lord of Asses #12 [2008, DVDxvid] - anal"
"290",564453,4545047,501,1331439872,17,99,"porn",116,82,"Ai Hanzawa - New face"
"291",564455,4545026,501,343136000,237,123,"porn",360,-114,"Not found"
"292",564456,4545025,501,849503872,156,669,"porn",825,513,"Not found"
"293",564460,4544943,501,775967232,31,209,"porn",240,178,"Not found"
"294",564461,4544942,501,1471026304,126,294,"porn",420,168,"Not found"
"295",564467,4544814,501,1471026304,92,52,"porn",144,-40,"It`s A Mommy Thing #3 [2008, DVD.xvid]  - anal, MILF, teen"
"296",564468,4544768,501,1481763712,36,215,"porn",251,179,"Not found"
"297",564480,4544709,599,564584768,361,1767,"porn",2128,1406,"Model Collection Select 44 - Rino Tokiwa in `Elegant Model`"
"298",564483,4544656,501,733520832,131,476,"porn",607,345,"Tora-Tora Gold Vol.2 : @YOU (natural busty: G-cup/94cm).avi"
"299",564487,4544534,501,1492501120,38,97,"porn",135,59,"Not found"
"300",564488,4544528,501,1492501120,31,172,"porn",203,141,"Not found"
"301",564492,4544504,501,1481763712,23,134,"porn",157,111,"Not found"
"302",564495,4544471,502,4692251648,35,122,"porn",157,87,"Not found"
"303",564496,4544459,501,1460288896,168,161,"porn",329,-7,"Not found"
"304",564497,4544447,501,1471026304,32,76,"porn",108,44,"Not found"
"305",564501,4544414,501,1471026304,52,75,"porn",127,23,"Not found"
"306",564503,4544408,501,1471026304,50,115,"porn",165,65,"Not found"
"307",564506,4544402,599,734925952,50,137,"porn",187,87,"Not found"
"308",564507,4544396,506,204105312,69,86,"porn",155,17,"Not found"
"309",564509,4544390,501,734129024,80,147,"porn",227,67,"Not found"
"310",564511,4544384,501,1460288896,33,87,"porn",120,54,"Not found"
"311",564512,4544371,501,1481763712,12,137,"porn",149,125,"Not found"
"312",564521,4544309,501,1481763712,29,140,"porn",169,111,"Not found"
"313",564522,4544293,501,719543360,1,737,"porn",738,736,"Not found"
"314",564523,4544286,501,732377920,35,90,"porn",125,55,"Sexxxy - Perdendo o Selinho com Caroline Miranda"
"315",564525,4544240,503,24001904,84,22,"porn",106,-62,"Not found"
"316",564527,4544219,501,1567663104,78,161,"porn",239,83,"Euro Sluts 6 - Flirt [DVD.xvid] - anal"
"317",564528,4544209,501,1707249536,86,146,"porn",232,60,"Euro Sluts 8 - Kiss Me [DVD.xvid] - anal"
"318",564529,4544203,501,362545152,72,53,"porn",125,-19,"PublicDisgrace-------PD-5784 Carmen Blue.wmv"
"319",564534,4544182,501,738952448,154,270,"porn",424,116,"Swank: Sugar Baby [2008, DVD.xvid] - anal"
"320",564540,4544165,501,1471026304,92,229,"porn",321,137,"Pigtail Party Teens [2008, DVD.xvid]"
"321",564543,4544145,501,1460288896,92,194,"porn",286,102,"MILF School Anal 101 [2008, DVDxvid]"
"322",564544,4544090,501,2136746240,54,215,"porn",269,161,"Not found"
"323",564547,4544025,501,718830336,109,352,"porn",461,243,"Not found"
"324",564549,4543980,501,1481763712,36,253,"porn",289,217,"Marc Dorcel - Education Anglaise Tres Severe: Le club des etudia"
"325",564552,4543865,501,1460288896,96,242,"porn",338,146,"Not found"
"326",564553,4543864,501,1460288896,112,338,"porn",450,226,"Not found"
"327",564554,4543859,501,2759516416,19,134,"porn",153,115,"Not found"
"328",564555,4543858,501,1471026304,136,356,"porn",492,220,"Not found"
"329",564559,4543784,501,1471026304,68,139,"porn",207,71,"Not found"
"330",564560,4543782,501,1471026304,17,84,"porn",101,67,"Bra.Busters.8.XXX.DVDRip.XviD-PLEASURE"
"331",564561,4543770,501,741531968,83,115,"porn",198,32,"Not found"
"332",564562,4543765,501,1471026304,75,136,"porn",211,61,"Not found"
"333",564568,4543723,501,711322496,44,57,"porn",101,13,"Not found"
"334",564569,4543708,501,730805056,46,100,"porn",146,54,"Not found"
"335",564571,4543698,501,1460288896,48,59,"porn",107,11,"Not found"
"336",564573,4543686,501,1471026304,80,94,"porn",174,14,"13 Cum Hungry Cocksuckers #8 [2008, DVD.xvid] - blowjobs"
"337",564574,4543685,501,1449551488,45,63,"porn",108,18,"Not found"
"338",564575,4543684,501,734181440,157,180,"porn",337,23,"Marc Dorcel - Sexe, Fric & Perversions / Money Pleasure (2006) -"
"339",564576,4543679,501,919223680,99,86,"porn",185,-13,"Marc Dorcel - Sequestrees (anal, DP, A2M, Lingerie)"
"340",564578,4543669,501,1460288896,27,92,"porn",119,65,"Not found"
"341",564579,4543666,506,61551412,93,18,"porn",111,-75,"Not found"
"342",564581,4543643,501,727627840,30,89,"porn",119,59,"Not found"
"343",564582,4543637,501,1964947584,22,120,"porn",142,98,"Not found"
"344",564584,4543609,599,159362576,100,28,"porn",128,-72,"Not found"
"345",564586,4543548,501,733657152,44,152,"porn",196,108,"Not found"
"346",564589,4543538,501,733206272,30,118,"porn",148,88,"Not found"
"347",564590,4543532,501,772527872,30,79,"porn",109,49,"Not found"
"348",564592,4543524,501,713608384,133,424,"porn",557,291,"Not found"
"349",564593,4543520,501,1513975936,71,153,"porn",224,82,"Not found"
"350",564594,4543500,501,1460288896,25,108,"porn",133,83,"Tranny Delights (repost)"
"351",564606,4543395,501,265111472,64,104,"porn",168,40,"Not found"
"352",564619,4543344,503,330217568,50,56,"porn",106,6,"[Met-Art] Sofi A Senninias [S7nt4x]"
"353",564622,4543300,501,393425728,30,83,"porn",113,53,"Not found"
"354",564623,4543298,504,1653562368,55,137,"porn",192,82,"kyou kara purinsu"
"355",564624,4543297,501,403366208,76,163,"porn",239,87,"Not found"
"356",564625,4543295,501,240962768,37,69,"porn",106,32,"Not found"
"357",564626,4543294,501,276079584,59,108,"porn",167,49,"Not found"
"358",564639,4543266,501,435494592,42,111,"porn",153,69,"Not found"
"359",564640,4543264,501,501418560,46,69,"porn",115,23,"Not found"
"360",564641,4543261,504,2662879744,47,213,"porn",260,166,"mainichi ga m"
"361",564643,4543209,504,703573504,71,153,"porn",224,82,"ai yatsu hentai choukyou kurabu"
"362",564644,4543165,501,704632576,150,405,"porn",555,255,"Not found"
"363",564645,4543161,501,1352914688,35,114,"porn",149,79,"Not found"
"364",564646,4543154,501,881800000,210,600,"porn",810,390,"Not found"
"365",564649,4543147,501,819650880,86,367,"porn",453,281,"Not found"
"366",564651,4543091,501,800273216,50,274,"porn",324,224,"Not found"
"367",564652,4543087,501,733384512,27,145,"porn",172,118,"Not found"
"368",564653,4543084,501,728466688,137,621,"porn",758,484,"Not found"
"369",564654,4543079,501,904742848,43,110,"porn",153,67,"Not found"
"370",564658,4542830,506,93690264,115,127,"porn",242,12,"Not found"
"371",564659,4542793,501,1385126912,21,101,"porn",122,80,"Behind Closed Doors - fetish-hardcore"
"372",564660,4542786,501,10168335360,5,151,"porn",156,146,"Pure18.com.Part3.XXX[SiteRip-08.11.29][GoldenPirates]"
"373",564661,4542781,501,10973641728,7,131,"porn",138,124,"Pure18.com.Part2.XXX[SiteRip-08.11.29][GoldenPirates]"
"374",564662,4542762,501,11886321664,11,211,"porn",222,200,"Pure18.com.Part1.XXX[SiteRip-08.11.29][GoldenPirates]"
"375",564672,4542746,501,1471026304,69,232,"porn",301,163,"Not found"
"376",564673,4542744,501,1471026304,89,223,"porn",312,134,"Not found"
"377",564674,4542741,501,1471026304,208,373,"porn",581,165,"Not found"
"378",564678,4542623,506,528859776,54,174,"porn",228,120,"GirlsGotCream - Reagan (anal,  tanlines, creampie)"
"379",564680,4542586,501,733835456,146,488,"porn",634,342,"Tora-Tora Gold Vol.1 : Rina (blindfold, outdoors).avi"
"380",564681,4542533,501,2394444288,43,438,"porn",481,395,"Not found"
"381",564684,4542466,501,1395864320,160,246,"porn",406,86,"Not found"
"382",564688,4542403,501,733667648,97,137,"porn",234,40,"Not found"
"383",564689,4542345,501,524392864,94,115,"porn",209,21,"Color Climax - Teenage Bestsellers 259 (all 5 scenes)"
"384",564696,4542235,501,1460288896,31,162,"porn",193,131,"Not found"
"385",564697,4542232,501,1471026304,20,160,"porn",180,140,"Not found"
"386",564699,4542183,501,1460288896,12,92,"porn",104,80,"Not found"
"387",564700,4542170,501,1460288896,23,101,"porn",124,78,"Not found"
"388",564702,4542143,501,1471026304,44,143,"porn",187,99,"Pigtail.Party.Teens.XXX.DVDRip.XviD-Pr0nStarS"
"389",564703,4542135,599,874397056,223,377,"porn",600,154,"Not found"
"390",564705,4542118,501,732472256,219,599,"porn",818,380,"Not found"
"391",564707,4542097,506,305596992,121,140,"porn",261,19,"Not found"
"392",564708,4542089,501,1460288896,1,103,"porn",104,102,"Spunkd 7(www . torrent4life . com)"
"393",564713,4542060,501,729127296,2,170,"porn",172,168,"Buttman - Que Delicia 2(www . torrent4life . com)"
"394",564714,4542052,501,974158592,31,98,"porn",129,67,"Not found"
"395",564715,4542004,506,359347008,244,164,"porn",408,-80,"Pure18 - Candace  (super hot slim in pink)"
"396",564716,4541984,501,578289664,38,69,"porn",107,31,"TsSeduction------5603- Rocky-Yasmin Lee.wmv"
"397",564718,4541889,501,1041833664,93,277,"porn",370,184,"Not found"
"398",564722,4541778,501,1460288896,65,330,"porn",395,265,"Not found"
"399",564723,4541777,501,1460288896,55,244,"porn",299,189,"Not found"
"400",564724,4541776,501,734317760,166,478,"porn",644,312,"Not found"
"401",564725,4541758,506,298141600,100,75,"porn",175,-25,"Clothed Female, Naked Man - Secret (CFNM)"
"402",564726,4541754,501,2576980480,21,128,"porn",149,107,"Backroom Facials 20-37"
"403",564727,4541749,501,1481763712,36,163,"porn",199,127,"Not found"
"404",564728,4541742,501,1460288896,33,190,"porn",223,157,"Not found"
"405",564731,4541731,501,2544768000,21,104,"porn",125,83,"Backroom Facials 01-19"
"406",564732,4541720,501,1471026304,17,86,"porn",103,69,"Not found"
"407",564738,4541693,501,1471026304,16,115,"porn",131,99,"Not found"
"408",564741,4541660,501,1105954048,109,456,"porn",565,347,"Teens In Thailand [DVD.xvid] - 100% Siam fresh-squeezed!"
"409",564742,4541623,501,742800768,23,113,"porn",136,90,"Not found"
"410",564743,4541615,501,1460288896,21,119,"porn",140,98,"Not found"
"411",564747,4541571,501,1481763712,1,122,"porn",123,121,"Not found"
"412",564748,4541567,501,405652096,42,59,"porn",101,17,"Not found"
"413",564749,4541565,501,1481763712,23,147,"porn",170,124,"Not found"
"414",564751,4541561,501,397620032,46,93,"porn",139,47,"Not found"
"415",564756,4541546,501,1471026304,1,190,"porn",191,189,"Not found"
"416",564758,4541537,501,328256704,54,126,"porn",180,72,"Not found"
"417",564763,4541527,599,728655488,67,285,"porn",352,218,"Sky Angel Vol.75 : Hibiki (anal, DP, rape fantasy) - Nov. 2008"
"418",564775,4541464,501,456581440,68,82,"porn",150,14,"Big Clit Wonder - Sexy MILF Gets Tied Up And Fucked.wmv"
"419",564778,4541447,501,1492501120,28,110,"porn",138,82,"Not found"
"420",564779,4541439,501,1460288896,36,74,"porn",110,38,"Not found"
"421",564783,4541421,501,733227264,52,91,"porn",143,39,"Not found"
"422",564787,4541401,501,1471026304,50,117,"porn",167,67,"Not found"
"423",564789,4541368,501,1320702464,50,206,"porn",256,156,"Not found"
"424",564790,4541366,501,1471026304,14,142,"porn",156,128,"Pop Goes The Weasel 2 XXX [DVDRiP] [Cumshots]"
"425",564791,4541328,501,733688640,70,125,"porn",195,55,"Not found"
"426",564792,4541319,501,711658048,91,380,"porn",471,289,"Not found"
"427",564798,4541294,501,1481763712,112,564,"porn",676,452,"Not found"
"428",564800,4541291,501,1438814080,27,143,"porn",170,116,"Not found"
"429",564801,4541287,501,1471026304,429,2715,"porn",3144,2286,"Not found"
"430",564802,4541286,501,1460288896,24,158,"porn",182,134,"Not found"
"431",564803,4541272,501,735817216,73,243,"porn",316,170,"Not found"
"432",564806,4541205,501,1471026304,29,152,"porn",181,123,"Trans Lover (2003)"
"433",564808,4541102,501,732734400,77,180,"porn",257,103,"Hustlers-Asian Fever 27 XXX"
"434",564810,4541054,501,1599875328,48,225,"porn",273,177,"Not found"
"435",564820,4541027,501,875969920,99,177,"porn",276,78,"Not found"
"436",564821,4540966,503,576622400,47,54,"porn",101,7,"Abby Winters Letter B (3004 pictures)"
"437",564824,4540813,501,4928475136,31,125,"porn",156,94,"LITTLE COCO.com entire site rip! Young Black teen!! (tigerdirect"
"438",564826,4540786,506,1868310784,17,101,"porn",118,84,"ALS SCAN Ember Charlie Brea Sophie"
"439",564828,4540744,501,1492501120,20,93,"porn",113,73,"Sweetheart Video: Lesbian - Truth Or Dare [2008, DVD.xvid]"
"440",564832,4540652,599,482103776,33,115,"porn",148,82,"Kamikaze Girls Vol.66 : Rin (lolita, baby-faced idol, 1st uncens"
"441",564837,4540592,501,1471026304,21,104,"porn",125,83,"Manhammer.8.XXX.DVDRip.XviD-NYMPHO"
"442",564838,4540587,501,731130112,72,231,"porn",303,159,"ITALIAN amateur: Mai...Cosi Grosso [2008] - anal, DP, interracia"
"443",564840,4540576,501,2201170688,42,143,"porn",185,101,"Not found"
"444",564844,4540558,501,733762048,41,71,"porn",112,30,"Not found"
"445",564845,4540556,501,1471026304,39,184,"porn",223,145,"Transsexual Barebackin` It #15 [2008, DVD.xvid][requested]"
"446",564847,4540548,501,1524713344,35,97,"porn",132,62,"Not found"
"447",564852,4540480,599,323223552,114,341,"porn",455,227,"Tora-Tora Platinum Vol.4 : Chihiro (anal, DP, Playboy bunny)"
"448",564860,4540278,501,1481763712,299,498,"porn",797,199,"Not found"
"449",564870,4540149,504,879419712,45,94,"porn",139,49,"Airebo"
"450",564871,4540137,504,3801046016,26,161,"porn",187,135,"Naisho Shishun Ki"
"451",564874,4540117,504,383789312,92,94,"porn",186,2,"Majikaru Juku Onna"
"452",564875,4540018,501,733279680,66,98,"porn",164,32,"Not found"
"453",564877,4539999,501,733615232,46,107,"porn",153,61,"Bisexual Barebacking 6 (2007, DVD.xvid)"
"454",564878,4539994,501,1471026304,30,93,"porn",123,63,"Not found"
"455",564883,4539939,501,821360064,2,177,"porn",179,175,"Not found"
"456",564888,4539853,501,737222336,58,167,"porn",225,109,"Red Hot Fetish Vol.70 : Shiho (anal, DP, bottle, blindfold).avi"
"457",564889,4539818,501,1471026304,83,271,"porn",354,188,"Not found"
"458",564890,4539816,501,10887742464,14,217,"porn",231,203,"JennaHaze.com[SiteRip-08.11.28][GoldenPirates]"
"459",564894,4539732,501,1471026304,39,141,"porn",180,102,"Not found"
"460",564895,4539722,501,721640512,119,390,"porn",509,271,"Not found"
"461",564896,4539712,506,434267744,61,78,"porn",139,17,"Not found"
"462",564897,4539704,506,503851264,63,88,"porn",151,25,"Not found"
"463",564900,4539689,506,433890272,57,81,"porn",138,24,"Not found"
"464",564905,4539654,501,805925056,277,154,"porn",431,-123,"Not found"
"465",564907,4539648,501,2866890752,74,467,"porn",541,393,"Not found"
"466",564911,4539630,501,1073741824,50,112,"porn",162,62,"French Shampoo 1978.avi"
"467",564912,4539601,501,889318272,119,276,"porn",395,157,"Not found"
"468",564919,4539529,501,2201170688,26,165,"porn",191,139,"Kristina Rose Dirty Girl XXX [DVDRip] [All Sex]"
"469",564920,4539525,501,732493248,49,85,"porn",134,36,"Club Jennas Family Jewels XXX [DVDRip] [All Sex]"
"470",564922,4539523,501,729043456,44,71,"porn",115,27,"Briana Banks Loves Cock XXX [DVDRip] [Pornstars]"
"471",564927,4539494,501,1492501120,18,106,"porn",124,88,"Not found"
"472",564928,4539491,501,1481763712,18,84,"porn",102,66,"Not found"
"473",564929,4539483,501,1460288896,42,153,"porn",195,111,"Brasileirinhas - Garotas da Mafia"
"474",564933,4539431,599,909209792,45,63,"porn",108,18,"Doctor Gyno Abuses Drugged sluts.mpg"
"475",564934,4539417,501,1481763712,44,143,"porn",187,99,"Fuck.My.Mom.And.Me.6.XviD-PORNOLATiON"
"476",564935,4539416,501,1460288896,81,307,"porn",388,226,"Not found"
"477",564937,4539381,501,1481763712,27,160,"porn",187,133,"Not found"
"478",564938,4539376,501,1481763712,22,119,"porn",141,97,"Not found"
"479",564939,4539357,501,734433088,115,161,"porn",276,46,"Not found"
"480",564946,4539192,599,735209088,111,364,"porn",475,253,"Kamikaze Girls Vol.65 : Miyu  [cute, lingerie].avi"
"481",564953,4539173,501,2931315200,25,158,"porn",183,133,"Not found"
"482",564954,4539171,501,2920577792,17,148,"porn",165,131,"Not found"
"483",564955,4539168,501,3103113984,27,112,"porn",139,85,"Not found"
"484",564956,4539163,501,2609192704,22,91,"porn",113,69,"Not found"
"485",564957,4539158,501,1556925696,33,101,"porn",134,68,"Not found"
"486",564960,4539151,501,1460288896,62,286,"porn",348,224,"Not found"
"487",564961,4539150,501,1728724352,44,139,"porn",183,95,"Not found"
"488",564962,4539143,501,995664832,143,422,"porn",565,279,"Prive Amateurs in Holland & Belgie (Dutch/Belgian amateur teen p"
"489",564966,4539107,501,733416000,24,87,"porn",111,63,"Not found"
"490",564972,4539084,506,82732648,116,45,"porn",161,-71,"Not found"
"491",564984,4539002,501,2190433280,98,572,"porn",670,474,"Not found"
"492",564985,4539001,501,1460288896,70,262,"porn",332,192,"Not found"
"493",564986,4538999,501,728414272,149,321,"porn",470,172,"Not found"
"494",564993,4538961,501,1460288896,169,313,"porn",482,144,"Not found"
"495",564994,4538956,501,1481763712,103,150,"porn",253,47,"Not found"
"496",564995,4538952,501,1471026304,241,500,"porn",741,259,"Not found"
"497",564996,4538947,501,1471026304,107,247,"porn",354,140,"Not found"
"498",564998,4538938,501,894257088,102,430,"porn",532,328,"Not found"
"499",564999,4538935,501,888164864,32,162,"porn",194,130,"Not found"
"500",565000,4538933,501,945563904,85,453,"porn",538,368,"Not found"
"501",565001,4538925,501,735932608,56,213,"porn",269,157,"Not found"
"502",565003,4538915,501,510132224,177,266,"porn",443,89,"Not found"
"503",565004,4538911,501,929457792,74,479,"porn",553,405,"Not found"
"504",565021,4538648,501,2813203456,39,213,"porn",252,174,"IDeepThroat.com.XXX.[SiteRip-08.11.28][GoldenPirates]"
"505",565035,4538492,501,747792000,311,902,"porn",1213,591,"Not found"
"506",565037,4538483,504,4348654592,100,471,"porn",571,371,"[HentaiShare].Realtime.Lovers.3 [3D]"
"507",565043,4538438,501,732461824,1,134,"porn",135,133,"Throated 13 (www . torrent4life . com)"
"508",565044,4538423,501,1471026304,1,173,"porn",174,172,"18 Enni Acerbe Ed Irrequiete Vol 3(www . torrent4life . com)"
"509",565046,4538412,501,1481763712,42,285,"porn",327,243,"Not found"
"510",565047,4538364,501,734045120,25,96,"porn",121,71,"Not found"
"511",565048,4538362,501,1932735232,14,149,"porn",163,135,"Not found"
"512",565052,4538299,501,1460288896,28,174,"porn",202,146,"Not found"
"513",565055,4538250,501,4552665088,32,80,"porn",112,48,"Not found"
"514",565056,4538247,501,1964947584,136,418,"porn",554,282,"Not found"
"515",565057,4538245,501,734433088,147,172,"porn",319,25,"Not found"
"516",565058,4538241,501,888374528,136,113,"porn",249,-23,"Not found"
"517",565061,4538160,501,365963520,183,131,"porn",314,-52,"Not found"
"518",565062,4538159,501,437895808,79,55,"porn",134,-24,"Not found"
"519",565063,4538150,501,1889785600,236,828,"porn",1064,592,"Not found"
"520",565069,4538021,501,820521216,1,262,"porn",263,261,"Brazzers - Pornstars Like It Big - Eva Angelina, Puma Swed, Rach"
"521",565078,4537975,501,733782976,1,201,"porn",202,200,"Sexxxy - Natal 100% Anal (www. torrent4life .com"
"522",565080,4537933,501,1943472640,19,110,"porn",129,91,"Not found"
"523",565086,4537833,501,733688640,42,110,"porn",152,68,"Not found"
"524",565090,4537819,501,734443584,36,135,"porn",171,99,"Not found"
"525",565093,4537678,501,1234803072,82,387,"porn",469,305,"Not found"
"526",565094,4537660,501,985063744,56,73,"porn",129,17,"Cyber Update nov.2008-----WP-5885- Kylie Ireland-Nina Isis L"
"527",565095,4537654,501,1001033536,132,218,"porn",350,86,"Porn Twins - #119 - Sasha & Misha - Russian Eigthteens - Yam Yam"
"528",565097,4537627,501,1460288896,23,78,"porn",101,55,"Not found"
"529",565103,4537572,599,343482048,40,154,"porn",194,114,"Kamikaze Premium Vol. 21 : Reiri  (petite, kimono)"
"530",565104,4537530,501,1460288896,1,438,"porn",439,437,"Not found"
"531",565111,4537448,501,922809792,30,142,"porn",172,112,"Not found"
"532",565116,4537419,501,1471026304,71,108,"porn",179,37,"Not found"
"533",565117,4537404,501,1449551488,224,523,"porn",747,299,"Not found"
"534",565118,4537391,501,1481763712,79,164,"porn",243,85,"Not found"
"535",565119,4537380,501,733856384,120,64,"porn",184,-56,"Not found"
"536",565120,4537364,501,1471026304,52,135,"porn",187,83,"Not found"
"537",565121,4537360,501,1481763712,328,650,"porn",978,322,"Not found"
"538",565123,4537352,501,1471026304,55,105,"porn",160,50,"Not found"
"539",565124,4537344,501,1481763712,53,108,"porn",161,55,"Not found"
"540",565126,4537329,506,365323872,171,112,"porn",283,-59,"FuckedHard18 - Kagney (Linn Karter)"
"541",565133,4537199,501,733416000,36,83,"porn",119,47,"Erotic Princess Vol.1 : Aya [2008, DVDrip.xvid]"
"542",565147,4537146,501,722594688,60,79,"porn",139,19,"Not found"
"543",565148,4537142,501,455302176,41,123,"porn",164,82,"Indecent Marika - Extreme Body Silhouette"
"544",565151,4537088,599,559090240,81,171,"porn",252,90,"Sky Angel Vol.56 : Risa [stunning slim brunette, hand-full tits]"
"545",565152,4537080,501,1471026304,1,177,"porn",178,176,"Not found"
"546",565154,4537064,501,2920577792,21,93,"porn",114,72,"Not found"
"547",565156,4537053,501,1471026304,43,76,"porn",119,33,"Not found"
"548",565159,4537033,501,732902208,161,251,"porn",412,90,"Not found"
"549",565166,4537003,506,311552896,55,61,"porn",116,6,"Not found"
"550",565169,4536975,501,1471026304,116,183,"porn",299,67,"Not found"
"551",565170,4536971,501,1460288896,154,424,"porn",578,270,"Not found"
"552",565171,4536950,501,1471026304,77,233,"porn",310,156,"Dutch teen sex: Tiener SexFilms  [Nederlands gesproken]"
"553",565172,4536941,501,1460288896,27,121,"porn",148,94,"Not found"
"554",565173,4536939,501,2190433280,24,102,"porn",126,78,"Not found"
"555",565174,4536938,501,2931315200,25,136,"porn",161,111,"Not found"
"556",565180,4536820,501,874428480,44,97,"porn",141,53,"Whos.Nailin.Paylin.2008.XXX.DVDRip.x264-x264Avengers"
"557",565184,4536591,501,1471026304,32,105,"porn",137,73,"Not found"
"558",565185,4536556,504,2544768000,30,105,"porn",135,75,"[HentaiShare].Shimai.Tsuma.3"
"559",565202,4536303,501,772360128,113,202,"porn",315,89,"Not found"
"560",565207,4536193,501,452900960,125,28,"porn",153,-97,"Not found"
"561",565208,4536185,501,457504192,232,188,"porn",420,-44,"Not found"
"562",565209,4536176,501,459119008,188,103,"porn",291,-85,"Not found"
"563",565213,4536086,501,1438814080,71,288,"porn",359,217,"Not found"
"564",565218,4535960,501,734087104,65,115,"porn",180,50,"The Trouble With Young Girls XXX [DVDRip] [Teens]"
"565",565219,4535944,501,733688640,75,240,"porn",315,165,"Not found"
"566",565220,4535927,501,853824000,73,83,"porn",156,10,"PublicDisgrace------PD-5518  Charlotte Vale.wmv"
"567",565223,4535893,501,1460288896,25,98,"porn",123,73,"Not found"
"568",565225,4535834,501,733227264,49,70,"porn",119,21,"Not found"
"569",565243,4535642,501,939440192,22,80,"porn",102,58,"Not found"
"570",565250,4535588,501,736708544,20,115,"porn",135,95,"Not found"
"571",565254,4535578,501,729043456,227,381,"porn",608,154,"Not found"
"572",565257,4535554,501,1481763712,20,89,"porn",109,69,"Not found"
"573",565261,4535544,506,452607360,39,70,"porn",109,31,"Not found"
"574",565264,4535528,501,1471026304,46,108,"porn",154,62,"Not found"
"575",565269,4535516,501,1471026304,71,164,"porn",235,93,"Not found"
"576",565272,4535503,501,1481763712,50,66,"porn",116,16,"Not found"
"577",565274,4535494,501,743650112,62,44,"porn",106,-18,"Not found"
"578",565278,4535419,504,3113851392,22,88,"porn",110,66,"shiru daku settai o kawari ichi hai me"
"579",565282,4535375,501,983438464,41,254,"porn",295,213,"Asian porn saga (DVDrip).avi"
"580",565286,4535321,506,13496934400,1,152,"porn",153,151,"Nubiles - J"
"581",565287,4535313,501,854159552,89,412,"porn",501,323,"Not found"
"582",565288,4535300,501,617999232,56,152,"porn",208,96,"Not found"
"583",565296,4535204,501,1471026304,27,80,"porn",107,53,"Brasileirinhas - Festa Anal"
"584",565298,4535171,504,1084479232,55,65,"porn",120,10,"LUST¡«´ßÒù³£‘B¡«"
"585",565300,4535115,501,994742080,133,431,"porn",564,298,"Street Girls"
"586",565308,4535069,506,457504192,55,89,"porn",144,34,"Baby Got Boobs - BRITNEY AMBER & MORGAN LAYNE **New November 26*"
"587",565313,4535034,506,177670720,100,16,"porn",116,-84,"Brittney Skye"
"588",565318,4535013,506,452900960,140,322,"porn",462,182,"MILFs Like It Big - DIAMOND FOXXX & PHOENIX MARIE **New November"
"589",565322,4534958,599,413222816,67,234,"porn",301,167,"Kamikaze Premium Vol. 22 : Rena (stylish, black lingerie)"
"590",565326,4534908,501,2211908096,28,132,"porn",160,104,"Not found"
"591",565327,4534870,501,652979712,51,59,"porn",110,8,"G-Queen: Miho Kawai (Japanese teen,shaved pussy,uncensored)"
"592",565338,4534750,501,731780224,84,173,"porn",257,89,"Not found"
"593",565348,4534674,501,2201170688,42,201,"porn",243,159,"Not found"
"594",565350,4534672,501,727072128,57,135,"porn",192,78,"Not found"
"595",565351,4534670,501,1460288896,30,71,"porn",101,41,"Not found"
"596",565352,4534666,501,1471026304,32,91,"porn",123,59,"Not found"
"597",565356,4534656,501,1460288896,38,80,"porn",118,42,"Not found"
"598",565401,4534037,501,585178816,102,35,"porn",137,-67,"Not found"
"599",565403,4533977,501,1460288896,88,106,"porn",194,18,"Not found"
"600",565406,4533956,501,732870720,83,56,"porn",139,-27,"Not found"
"601",565408,4533932,501,1460288896,83,118,"porn",201,35,"Not found"
"602",565410,4533907,501,1471026304,64,57,"porn",121,-7,"Not found"
"603",565411,4533906,501,1460288896,17,125,"porn",142,108,"Not found"
"604",565413,4533887,501,1481763712,37,93,"porn",130,56,"Not found"
"605",565414,4533854,501,2190433280,28,109,"porn",137,81,"Not found"
"606",565419,4533680,501,733227264,64,56,"porn",120,-8,"Not found"
"607",565423,4533583,501,730951872,30,123,"porn",153,93,"Daring! Magic Graffiti  (2006) - anal, DP"
"608",565424,4533560,501,1492501120,28,82,"porn",110,54,"Not found"
"609",565425,4533546,599,448025056,73,273,"porn",346,200,"KAMIKAZE GIRLS Vol.20 : Emiri (perky tits)"
"610",565426,4533532,501,1008520384,66,256,"porn",322,190,"Not found"
"611",565428,4533508,501,1299227648,24,162,"porn",186,138,"Not found"
"612",565430,4533492,501,917566912,118,389,"porn",507,271,"Not found"
"613",565433,4533458,501,993630592,23,124,"porn",147,101,"Not found"
"614",565435,4533451,501,746491712,44,117,"porn",161,73,"Not found"
"615",565452,4533340,501,1481763712,48,115,"porn",163,67,"Not found"
"616",565453,4533331,501,1471026304,64,119,"porn",183,55,"Not found"
"617",565461,4533217,501,993284608,39,133,"porn",172,94,"INDIAN lesbians teenies (2 videos) - 5 real amateur teens"
"618",565464,4533161,501,2942052608,28,101,"porn",129,73,"Not found"
"619",565468,4533124,501,1471026304,31,112,"porn",143,81,"Not found"
"620",565470,4533107,501,728749824,94,118,"porn",212,24,"Not found"
"621",565504,4532661,501,1471026304,27,87,"porn",114,60,"Not found"
"622",565506,4532651,501,1481763712,26,112,"porn",138,86,"Not found"
"623",565514,4532508,501,893470656,96,203,"porn",299,107,"German mature: Hammerfeste Ehe-Huren [DVD.Divx] - anal,DP"
"624",565517,4532470,501,1460288896,48,133,"porn",181,85,"Not found"
"625",565521,4532458,501,1460288896,26,81,"porn",107,55,"Not found"
"626",565522,4532457,501,725887232,36,66,"porn",102,30,"Not found"
"627",565523,4532455,501,1460288896,42,140,"porn",182,98,"Not found"
"628",565529,4532426,501,732755392,136,231,"porn",367,95,"Not found"
"629",565549,4532272,501,1471026304,44,186,"porn",230,142,"Shemale: When Trannys Attack #2: Orgy Extravaganza [2008,DVD.xvi"
"630",565556,4532227,503,1066192064,13,93,"porn",106,80,"===XXX_PICTURE===.ZIP"
"631",565558,4532151,501,1460288896,55,123,"porn",178,68,"Tiny Tits #1  [Nov. 2008, DVD.xvid] - ATK/ Amateur Teen Kingdom:"
"632",565565,4532021,501,739413824,181,164,"porn",345,-17,"Not found"
"633",565568,4531986,501,1481763712,29,81,"porn",110,52,"Not found"
"634",565571,4531959,506,788717888,55,55,"porn",110,0,"Not found"
"635",565573,4531940,501,1481763712,49,66,"porn",115,17,"Not found"
"636",565586,4531581,501,1481763712,60,63,"porn",123,3,"Not found"
"637",565588,4531569,501,843862528,78,55,"porn",133,-23,"Not found"
"638",565601,4531393,501,2201170688,34,148,"porn",182,114,"Furious Fuckers 2: Final Race [Rocco Siffredi] + Simpsons bonus"
"639",565603,4531356,501,919831808,133,96,"porn",229,-37,"Not found"
"640",565611,4531249,501,1535450752,22,91,"porn",113,69,"Not found"
"641",565614,4531232,501,2201170688,34,82,"porn",116,48,"Not found"
"642",565615,4531230,501,2888365568,28,167,"porn",195,139,"Not found"
"643",565616,4531225,599,427724640,40,107,"porn",147,67,"KAMIKAZE GIRLS Vol.19 : Mami (threesome)"
"644",565625,4531186,501,734747712,68,55,"porn",123,-13,"Not found"
"645",565654,4531010,599,519621824,26,115,"porn",141,89,"Kamikaze Premium Vol.08 : Ai Himeno (nurse,glasses,clothed sex)"
"646",565659,4530984,599,305607488,29,88,"porn",117,59,"Kamikaze Premium Vol.12 : Sally (slim & flexible,small tits)"
"647",565670,4530911,501,733929792,54,191,"porn",245,137,"Not found"
"648",565673,4530900,501,1127428864,16,97,"porn",113,81,"Not found"
"649",565679,4530852,599,518405504,44,102,"porn",146,58,"KAMIKAZE GIRLS Vol.14 : Hayama (petite, yet very busty)"
"650",565682,4530820,599,594269952,77,309,"porn",386,232,"KAMIKAZE GIRLS Vol.18 : Maiko (TOP tits, oh so hairy bush)"
"651",565684,4530796,501,953166080,34,117,"porn",151,83,"Not found"
"652",565686,4530760,501,1342177280,131,414,"porn",545,283,"Not found"
"653",565705,4530585,505,4692251648,71,152,"porn",223,81,"Not found"
"654",565706,4530584,599,5400921600,16,300,"porn",316,284,"Japanese Rape Fantasy (DVDrip.) - 4 movies/8 hours"
"655",565707,4530579,501,1428076672,42,63,"porn",105,21,"Not found"
"656",565717,4530494,506,119873208,93,25,"porn",118,-68,"Not found"
"657",565723,4530427,599,10683730944,37,553,"porn",590,516,"Sci-Fi & fighters porn (DVDrip - Japanese) - 7 movies"
"658",565744,4530163,599,314184832,37,116,"porn",153,79,"Kamikaze Premium Vol.14 : Jun Nada [redhead,small tits,fishnets,"
"659",565748,4530117,501,1460288896,20,85,"porn",105,65,"World`s Famous Blowjobs 2 [2008] - Legendary cocksucking at its "
"660",565750,4530111,501,1460288896,19,122,"porn",141,103,"Not found"
"661",565751,4530110,501,1471026304,18,86,"porn",104,68,"Not found"
"662",565753,4530106,501,1524713344,22,86,"porn",108,64,"Not found"
"663",565762,4530022,599,170970320,37,81,"porn",118,44,"Sex & Zen (1992).rmvb - erotic saga"
"664",565763,4529995,501,1471026304,45,150,"porn",195,105,"Not found"
"665",565764,4529993,501,1471026304,22,142,"porn",164,120,"Not found"
"666",565773,4529879,599,198222800,181,446,"porn",627,265,"Japanese couple sex  (big tits) - uncensored"
"667",565778,4529837,501,741573888,80,67,"porn",147,-13,"Not found"
"668",565794,4529718,506,178918528,88,99,"porn",187,11,"18eighteen - Lacie (tight blonde teen)"
"669",565798,4529667,501,2952790016,33,76,"porn",109,43,"Not found"
"670",565801,4529655,506,212084976,37,212,"porn",249,175,"TeensTryAnal - Sapphire"
"671",565834,4529465,501,1471026304,57,67,"porn",124,10,"Not found"
"672",565837,4529453,501,1481763712,51,62,"porn",113,11,"Not found"
"673",565838,4529444,501,691798016,126,461,"porn",587,335,"Not found"
"674",565851,4529239,599,222235200,55,71,"porn",126,16,"Teen Layla, part #2 - Extreme insertions / fisting"
"675",565868,4528994,599,12036645888,37,621,"porn",658,584,"Yellow - Gokujyo (collection of 9 Japanese DVDrip).avi"
"676",565873,4528669,501,925494144,32,124,"porn",156,92,"Not found"
"677",565875,4528644,501,865903552,100,288,"porn",388,188,"Not found"
"678",565877,4528618,501,1471026304,45,151,"porn",196,106,"Shemale - She Fucked My Ass #7: Bareback [2008,DVD.xvid]"
"679",565879,4528482,501,1471026304,42,99,"porn",141,57,"Not the Bradys #2 [2008] - Teagan Presley,Alexis love,Maya Gates"
"680",565880,4528412,501,1460288896,43,115,"porn",158,72,"Big Natural Tits #20 [2008,DVD.xvid] - anal, A2M, rough sex"
"681",565883,4528343,501,1138166272,90,146,"porn",236,56,"Brazilian + ANAL: 19 yo Caroline [Nov.2008, DVDrip]"
"682",565885,4528326,501,2007897216,34,89,"porn",123,55,"Not found"
"683",565886,4528323,501,1471026304,33,74,"porn",107,41,"Not found"
"684",565888,4528317,501,1578400512,48,134,"porn",182,86,"Not found"
"685",565916,4527999,599,569607424,40,74,"porn",114,34,"Raped Without Mercy.mpg"
"686",565929,4527893,501,733300672,18,89,"porn",107,71,"Not found"
"687",565932,4527886,501,731811648,50,184,"porn",234,134,"Not found"
"688",565935,4527809,501,1471026304,63,160,"porn",223,97,"Big Tits At School 4 XXX [DVDRip] [Schoolgirls]"
"689",565946,4527664,503,2974264832,44,119,"porn",163,75,"Abby Winters Letter A (13238 pictures)"
"690",565956,4527548,501,1921997824,45,135,"porn",180,90,"Not found"
"691",565961,4527413,501,1267015296,116,345,"porn",461,229,"Not found"
"692",565964,4527344,501,1460288896,39,131,"porn",170,92,"Win A Milf Daughter 2008 XXX [DVDRip][Mature]"
"693",565965,4527339,501,1460288896,35,102,"porn",137,67,"Ritual XXX [DVDRIP]."
"694",565966,4527332,501,1460288896,69,193,"porn",262,124,"I Wanna Cum Inside Your Mom 13 XXX [DVDRIP][Mature]."
"695",565983,4527050,501,1342177280,48,109,"porn",157,61,"Carol Miranda - Fiz Porno e continuo Virgem"
"696",565987,4527014,503,8074538496,20,147,"porn",167,127,"Graphis GIRLS"
"697",566005,4526627,501,1471026304,1,114,"porn",115,113,"Tits A Poppin XXX [DVDRip][Big Boobs][blogsexcetera.blogspot.com"
"698",566010,4526401,501,267187648,47,176,"porn",223,129,"so buteaful girl~!"
"699",566040,4526004,505,9577777152,27,302,"porn",329,275,"Hungarian.Honeys.XXX.720p.Siterip"
"700",566050,4525902,501,1471026304,46,118,"porn",164,72,"Party Hardcore 26 2008 XXX [DVDRip] [Orgy]"
"701",566053,4525804,501,732283520,54,50,"porn",104,-4,"American MILF [DVD.xvid]"
"702",566059,4525743,501,1460288896,50,139,"porn",189,89,"Seventeen (17): Summertime - anal, outdoors [teen torrent].xvid"
"703",566084,4525380,501,1471026304,70,62,"porn",132,-8,"Not found"
"704",566112,4525078,501,633623040,39,128,"porn",167,89,"Not found"
"705",566117,4525048,501,1460288896,14,117,"porn",131,103,"Not found"
"706",566119,4525038,501,725593600,54,123,"porn",177,69,"Not found"
"707",566130,4524906,501,1460288896,191,622,"porn",813,431,"World Class Ass 5 XXX [DVDRIP][Anal]"
"708",566147,4524710,503,18028126208,15,180,"porn",195,165,"[Met-Art] Jenya D 55 Sets 1 Vid [S7nt4x]"
"709",566168,4524459,501,486539264,107,73,"porn",180,-34,"Not found"
"710",566169,4524458,501,2007897216,42,180,"porn",222,138,"Young Harlots - Dirty Secrets [2008,split] - anal, DP,uniform"
"711",566171,4524429,501,1707249536,77,335,"porn",412,258,"Shemale: Tricked By A Tranny [2008, DVD.xvid] + bonus"
"712",566174,4524385,506,439678400,1,201,"porn",202,200,"Not found"
"713",566189,4524012,501,4638564864,38,126,"porn",164,88,"Nudist and Naturist Beach Girls Movies - Pack 04"
"714",566231,4523088,501,1481763712,56,64,"porn",120,8,"Not found"
"715",566235,4523071,501,248774656,137,22,"porn",159,-115,"Bella Donna Gangbang & Anal Creampies (2008) XXX CamRip"
"716",566250,4522844,501,1578400512,32,77,"porn",109,45,"(Gay Porn) Eurocreme - Bare Instinct"
"717",566264,4522723,501,428196480,50,117,"porn",167,67,"Not found"
"718",566265,4522720,501,479838848,68,160,"porn",228,92,"Not found"
"719",566269,4522700,501,763541568,60,62,"porn",122,2,"Not found"
"720",566272,4522567,599,333824640,71,113,"porn",184,42,"Sexy Asian brunette teen in steaming prison sex"
"721",566279,4522432,501,888374528,53,124,"porn",177,71,"Marc Dorcel - Liaisons Coupables [1987] - incest fantasy"
"722",566283,4522348,502,4681514496,28,105,"porn",133,77,"Athlitries, Sex & Ntopa [GREEK PORN]"
"723",566288,4522270,599,462422016,178,502,"porn",680,324,"Uncensored Chinese porn: Lisa & Vivian [2008]"
"724",566292,4522214,501,733961280,36,87,"porn",123,51,"Italian X - Sperma Party 3 [DVDrip.xvid]"
"725",566328,4521600,501,1460288896,38,66,"porn",104,28,"Not found"
"726",566334,4521410,501,947105280,48,122,"porn",170,74,"Italian X - Piu` di un Autografo (Mario Salieri, 1999).avi"
"727",566337,4521349,501,1524713344,1,120,"porn",121,119,"Not found"
"728",566340,4521314,501,1471026304,36,77,"porn",113,41,"Not found"
"729",566341,4521300,501,1460288896,64,177,"porn",241,113,"Transsexual Babysitters #8 [DVD.xvid - SPLIT SCENES]"
"730",566362,4521066,502,3575560192,19,102,"porn",121,83,"Gangbanged by Transsexuals 3 (2008)"
"731",566376,4520775,501,883834240,55,54,"porn",109,-1,"Not found"
"732",566384,4520708,501,11188389888,11,209,"porn",220,198,"AnalTeenAngels.com.XXX[SiteRip-08.11.20][GoldenPirates]"
"733",566396,4520541,501,732975616,246,83,"porn",329,-163,"Vivian Schmitt: Feuchte Lippen (2008) XXX DVDRip"
"734",566410,4520343,501,770241984,32,116,"porn",148,84,"Not found"
"735",566411,4520332,501,898692544,31,85,"porn",116,54,"Not found"
"736",566425,4520104,501,2265595136,1,159,"porn",160,158,"The Best of Brandi Belle"
"737",566434,4520029,501,1277752832,87,185,"porn",272,98,"Not found"
"738",566454,4519814,501,747183808,67,37,"porn",104,-30,"Not found"
"739",566456,4519745,501,733741056,62,104,"porn",166,42,"Not found"
"740",566475,4519486,501,1481763712,79,187,"porn",266,108,"Not found"
"741",566484,4519434,501,1492501120,1,146,"porn",147,145,"Not found"
"742",566485,4519420,501,1471026304,31,93,"porn",124,62,"Not found"
"743",566488,4519346,599,5304284672,14,104,"porn",118,90,"Not found"
"744",566489,4519337,501,2190433280,42,155,"porn",197,113,"Not found"
"745",566496,4519224,599,4681514496,19,125,"porn",144,106,"Not found"
"746",566497,4519186,501,841230592,70,202,"porn",272,132,"Not found"
"747",566498,4519123,501,1471026304,48,103,"porn",151,55,"Couples Seduce Teens 10 (2008, xvid) [teen torrent]"
"748",566500,4519082,599,448413056,146,460,"porn",606,314,"Not found"
"749",566502,4519058,501,1460288896,97,181,"porn",278,84,"Pure18 - Vol.5 (2008,DVD.xvid) [teen torrent]"
"750",566510,4518987,501,1471026304,24,88,"porn",112,64,"Not found"
"751",566512,4518980,501,1471026304,38,93,"porn",131,55,"Not found"
"752",566541,4518529,505,75741749248,6,102,"porn",108,96,"Not found"
"753",566557,4518398,501,733594240,12,93,"porn",105,81,"Not found"
"754",566560,4518384,503,2201170688,18,116,"porn",134,98,"Not found"
"755",566659,4517160,501,22140557312,9,152,"porn",161,143,"Joe D'Amato's - 25 XXX Movies Mega Collection.[Joe D'Amato Pr"
"756",566665,4516967,599,58701463552,4,122,"porn",126,118,"Not found"
"757",566684,4516381,504,1428076672,55,49,"porn",104,-6,"[HentaiShare].Reversible[ANIMATED]"
"758",566699,4515862,501,732315008,78,364,"porn",442,286,"Not found"
"759",566716,4515656,501,734842048,34,76,"porn",110,42,"Not found"
"760",566730,4515574,505,22838489088,16,113,"porn",129,97,"Not found"
"761",566734,4515535,501,1567663104,62,77,"porn",139,15,"Not found"
"762",566743,4515457,501,1481763712,1,188,"porn",189,187,"Not found"
"763",566773,4515195,501,943246528,29,97,"porn",126,68,"Not found"
"764",566774,4515159,599,923680128,48,125,"porn",173,77,"Not found"
"765",566778,4515083,599,681742144,49,160,"porn",209,111,"Not found"
"766",566879,4513352,503,7537667584,36,159,"porn",195,123,"[Galitsin News] 995 Sets [S7nt4x]"
"767",566902,4513130,501,734569408,75,159,"porn",234,84,"Not found"
"768",566903,4513129,502,4692251648,1,106,"porn",107,105,"Not found"
"769",566919,4513056,501,1997159808,30,91,"porn",121,61,"Not found"
"770",566931,4512859,501,1471026304,35,78,"porn",113,43,"Not found"
"771",566983,4511919,501,813212608,49,189,"porn",238,140,"Not found"
"772",566999,4511305,501,732556160,60,80,"porn",140,20,"GGG - Titten-Blondie schluckt.avi"
"773",567000,4511297,501,727072128,48,69,"porn",117,21,"Actiongirls.Com 5 XXX [DVDRip] [All Sex]"
"774",567028,4510898,501,1471026304,56,113,"porn",169,57,"Not found"
"775",567048,4510718,501,768155328,36,65,"porn",101,29,"Not found"
"776",567145,4509355,501,1015461952,32,119,"porn",151,87,"Not found"
"777",567147,4509348,501,730763072,121,126,"porn",247,5,"What Girls Like XXX [DVDRIP][All Sex]"
"778",567149,4509341,501,2190433280,34,87,"porn",121,53,"Fistflush XXX [DVDRip][Extreme Hardcore]"
"779",567155,4509310,501,7569880064,16,119,"porn",135,103,"Not found"
"780",567161,4509288,501,1471026304,32,79,"porn",111,47,"Not found"
"781",567251,4508360,501,496133728,86,59,"porn",145,-27,"Not found"
"782",567263,4508199,501,1460288896,58,128,"porn",186,70,"Not found"
"783",567267,4508162,501,867476416,43,80,"porn",123,37,"Not found"
"784",567319,4507114,501,730207360,59,97,"porn",156,38,"Not found"
"785",567447,4506061,501,1460288896,38,104,"porn",142,66,"My First Sex Teacher 15 XXX [DVDRip][Gonzo]"
"786",567449,4506035,501,2931315200,22,118,"porn",140,96,"Boobstravaganza 11 XXX [DVDRIP][Big Boobs]"
"787",567541,4504445,501,966661248,21,82,"porn",103,61,"Not found"
"788",567585,4503800,501,1471026304,6,105,"porn",111,99,"Not found"
"789",567648,4503011,501,731214016,238,152,"porn",390,-86,"Mad Sex Party- Pussy Prison (2008) XXX DVDRip"
"790",567692,4502067,501,677065536,17,86,"porn",103,69,"Not found"
"791",567694,4502051,501,706194944,30,96,"porn",126,66,"Not found"
"792",567696,4502040,501,945165440,26,101,"porn",127,75,"Not found"
"793",567761,4501092,501,2695091968,15,96,"porn",111,81,"Transsexual Beauty Queens 37 (2008)"
"794",567818,4500333,501,738071680,9,98,"porn",107,89,"Not found"
"795",567868,4499457,599,403229888,63,48,"porn",111,-15,"Not found"
"796",567897,4498793,506,728907136,77,38,"porn",115,-39,"Not found"
"797",567929,4498085,501,729504832,29,89,"porn",118,60,"Not found"
"798",567959,4497858,501,732702976,28,78,"porn",106,50,"Not found"
"799",567960,4497851,501,735586560,186,154,"porn",340,-32,"Not found"
"800",568077,4496474,501,621323200,25,119,"porn",144,94,"Not found"
"801",568128,4495399,501,1460288896,27,97,"porn",124,70,"Not found"
"802",568146,4495171,501,734642816,48,85,"porn",133,37,"Not found"
"803",568148,4495135,501,1728724352,40,87,"porn",127,47,"Alexis.Texas.Is.Buttwoman.2008.XXX.DVDRip.x264-x264Avengers"
"804",568158,4494956,501,1471026304,60,129,"porn",189,69,"Not found"
"805",568164,4494900,501,728047296,173,66,"porn",239,-107,"Not found"
"806",568193,4494528,501,1460288896,45,84,"porn",129,39,"Not found"
"807",568275,4493359,501,1116691456,43,186,"porn",229,143,"Not found"
"808",568302,4493083,501,931942912,27,122,"porn",149,95,"Not found"
"809",568329,4492495,501,735009856,100,159,"porn",259,59,"Not found"
"810",568336,4492291,501,8815420416,6,98,"porn",104,92,"Not found"
"811",568337,4492289,501,12283606016,6,100,"porn",106,94,"Not found"
"812",568339,4492280,501,13561359360,10,122,"porn",132,112,"Not found"
"813",568340,4492278,501,14055280640,19,170,"porn",189,151,"Not found"
"814",568341,4492274,501,36270997504,4,150,"porn",154,146,"Not found"
"815",568353,4492153,501,2222645504,15,92,"porn",107,77,"Not found"
"816",568374,4491645,501,1060540224,23,115,"porn",138,92,"Not found"
"817",568619,4488518,501,1460288896,48,98,"porn",146,50,"Not found"
"818",568640,4488182,501,745359296,30,82,"porn",112,52,"Aus.dem.Versteck.beobachtet.German.2008.XXX.DVDRiP.XviD-WDE"
"819",568710,4487238,501,1277752832,28,82,"porn",110,54,"Not found"
"820",568714,4487209,501,1299227648,37,94,"porn",131,57,"Not found"
"821",568718,4487155,501,732514240,146,172,"porn",318,26,"Milf Soup 8 2008 XXX [DVDRIP][Mature]"
"822",568740,4486797,506,96364136,141,100,"porn",241,-41,"The hottest blonde teen sandwich ever.mpg"
"823",568970,4483167,501,112882475008,11,509,"porn",520,498,"Not found"
"824",568971,4483163,501,55823839232,4,149,"porn",153,145,"Not found"
"825",568990,4482945,501,314038016,451,108,"porn",559,-343,"High school girls fucking the dude (2008) CAMRip"
"826",569068,4481964,501,2909840384,30,125,"porn",155,95,"Not found"
"827",569148,4480353,506,318830016,66,45,"porn",111,-21,"Not found"
"828",569184,4479954,501,732524736,74,47,"porn",121,-27,"Hockey Moms XXX [DVDRiP] [Mature]"
"829",569188,4479944,501,46235324416,12,195,"porn",207,183,"Not found"
"830",569189,4479942,501,46697033728,7,215,"porn",222,208,"Not found"
"831",569190,4479918,501,32233730048,7,169,"porn",176,162,"Not found"
"832",569191,4479914,501,12970801152,12,119,"porn",131,107,"Not found"
"833",569219,4479374,501,829497024,29,230,"porn",259,201,"Not found"
"834",569245,4478962,501,1471026304,23,88,"porn",111,65,"Not found"
"835",569299,4478057,506,37140729856,15,390,"porn",405,375,"120 Favorite Scenes"
"836",569374,4476892,501,734359744,111,37,"porn",148,-74,"Visage Films - The Love Box (2008) XXX DVDRip"
"837",569436,4475451,501,733311168,100,57,"porn",157,-43,"Not found"
"838",569448,4475346,501,9534827520,17,161,"porn",178,144,"Private Penthouse - Full 1-12 (Silvia Saint, Monica Sweetheart, "
"839",569456,4475107,501,1481763712,48,73,"porn",121,25,"Porn Twins - #111 - Airi & Meiri - Double Lolita"
"840",569495,4474298,501,1471026304,1,100,"porn",101,99,"Not found"
"841",569630,4472013,501,1053860800,67,145,"porn",212,78,"Not found"
"842",569677,4471174,501,8804682752,12,134,"porn",146,122,"Hustler - Barely Legal [61-70]"
"843",569695,4470953,501,726442944,68,38,"porn",106,-30,"Russian.Institute.Lesson.2.DVDrip.avi"
"844",569827,4468663,501,1460288896,72,104,"porn",176,32,"The Voyeur (2008) - Rebeca Linares,Tori Black,Mackenzee Pierce"
"845",569829,4468648,501,2179695872,119,224,"porn",343,105,"Sex Maniac Bitches (2008) - anal, DP, fisting, outdoors"
"846",570050,4464883,501,1964947584,25,80,"porn",105,55,"Not found"
"847",570061,4464692,502,9330816000,22,101,"porn",123,79,"Not found"
"848",570106,4463883,501,8654359552,11,110,"porn",121,99,"Hustler - Barely Legal [51-60]"
"849",570159,4463229,501,723758592,110,47,"porn",157,-63,"Russian.Institute.Lesson.1.avi"
"850",570478,4458459,501,1599875328,61,53,"porn",114,-8,"Pirates.2.Stagnettis.Revenge.DiSC2.XXX.DVDRip.x264-x264Avengers"
"851",570479,4458446,501,1395864320,44,85,"porn",129,41,"Big Ass Shemale Road Trip #11 (2005)"
"852",570544,4456926,501,379626464,41,72,"porn",113,31,"Not found"
"853",570568,4456593,501,1363652096,50,59,"porn",109,9,"Pirates.2.Stagnettis.Revenge.DiSC1.XXX.DVDRip.x264-x264Avengers"
"854",570573,4456441,501,1438814080,37,83,"porn",120,46,"Shemale Road Trip #5 (2003)"
"855",570605,4455620,501,842845376,118,462,"porn",580,344,"Not found"
"856",570615,4455369,504,10307921920,11,101,"porn",112,90,"35 Hentai Games"
"857",570635,4454837,599,19187767296,28,296,"porn",324,268,"(private) X Castings - COMPLETE - Fucked by Pierre Woodman"
"858",570699,4453678,501,7355131392,22,136,"porn",158,114,"Hustler - Barely Legal [31-40]"
"859",570801,4451828,506,132372232,139,21,"porn",160,-118,"Sarah Palin Hustler Movie Sc 1 - Nailin Paylin - Omerta"
"860",570812,4451556,506,128932904,95,7,"porn",102,-88,"Not found"
"861",570822,4451257,501,3972844800,78,141,"porn",219,63,"Not found"
"862",570887,4450030,506,3221225472,26,92,"porn",118,66,"zootube365 rip - part 4 of 4"
"863",570950,4449023,501,2920577792,48,73,"porn",121,25,"Teen Mania 2 [DVDRip] [English] [Legal Teens] [XXX]"
"864",571020,4447741,501,1460288896,59,47,"porn",106,-12,"Not found"
"865",571091,4446719,506,5336496640,13,153,"porn",166,140,"zootube365 rip - part 3 of 4"
"866",571132,4446010,506,6410238464,16,154,"porn",170,138,"zootube365 rip - part 2 of 4"
"867",571216,4444779,506,6184753152,21,155,"porn",176,134,"zootube365 rip - part 1 of 4"
"868",571226,4444612,501,732765888,377,304,"porn",681,-73,"Farmers Daughters (2008) XXX DVDRip"
"869",571262,4443960,501,3661459712,20,94,"porn",114,74,"Hustler - Barely Legal [81-86] (missing #85)"
"870",571263,4443958,501,8783208448,31,147,"porn",178,116,"Hustler - Barely Legal [71-80]"
"871",571264,4443955,501,7849052672,25,174,"porn",199,149,"Hustler - Barely Legal [41-50]"
"872",571265,4443953,501,8214125056,23,181,"porn",204,158,"Hustler - Barely Legal [21-30]"
"873",571266,4443951,501,8847632384,21,209,"porn",230,188,"Hustler - Barely Legal [11-20]"
"874",571267,4443948,501,8847632384,52,325,"porn",377,273,"Hustler - Barely Legal [01-10]"
"875",571316,4443193,506,19638738944,18,164,"porn",182,146,"Lilly Thai - Collection"
"876",571333,4443074,501,3908420352,39,88,"porn",127,49,"Not found"
"877",571337,4442991,501,821496384,68,76,"porn",144,8,"Max Hardcore - Schoolgirls #13 (1999) - anal,fisting,peeing,extr"
"878",571380,4442190,501,656114944,89,46,"porn",135,-43,"Traci Lords - (1985) Educating Mandy.....FFF"
"879",571625,4437182,506,5347234304,16,112,"porn",128,96,"CumFu.com Site Rip - Asian Chicks!!! Asa Akira, Kina Kai, Jandi"
"880",571734,4435646,501,1460288896,69,62,"porn",131,-7,"Not found"
"881",571943,4431692,506,1005060096,113,780,"porn",893,667,"Not found"
"882",572050,4429922,501,741112576,48,71,"porn",119,23,"Not found"
"883",572065,4429586,505,6871947776,32,157,"porn",189,125,"Not found"
"884",572143,4428664,501,1159641216,69,77,"porn",146,8,"Not found"
"885",572301,4426377,506,161270992,90,36,"porn",126,-54,"Brother Sister Incest REAL -  .wmv"
"886",572323,4426054,501,734999360,141,26,"porn",167,-115,"Private Tropical 40 - Boroka Does the Caribbean (DVDRip)"
"887",572398,4424581,501,1460288896,72,123,"porn",195,51,"Not found"
"888",572425,4424221,505,6871947776,29,119,"porn",148,90,"Not found"
"889",572516,4422391,501,1460288896,49,62,"porn",111,13,"Not found"
"890",572518,4422380,501,2201170688,46,110,"porn",156,64,"Not found"
"891",572588,4421143,506,1921997824,28,77,"porn",105,49,"Not found"
"892",572693,4419174,501,636349312,131,193,"porn",324,62,"Shemale Teenage Transsexuals 5"
"893",572733,4418637,501,1782411392,46,90,"porn",136,44,"Not found"
"894",572785,4417569,501,1471026304,31,73,"porn",104,42,"Shemale XTC 4 (2008)"
"895",572807,4417295,501,1471026304,418,443,"porn",861,25,"Pirates 2 Stagnetti's Revenge"
"896",572832,4417053,501,732986112,261,68,"porn",329,-193,"Young And Nasty #3 (2008) XXX DVDRip"
"897",573025,4413997,501,6034428928,58,382,"porn",440,324,"American Daydreams - Complete Set!!"
"898",573036,4413837,501,1471026304,44,102,"porn",146,58,"Gay - Bareback Fuck Club"
"899",573052,4413498,501,738019264,60,67,"porn",127,7,"Not found"
"900",573108,4412781,501,1460288896,51,63,"porn",114,12,"Not found"
"901",573129,4412490,501,1481763712,39,86,"porn",125,47,"Not found"
"902",573168,4411856,501,1460288896,63,127,"porn",190,64,"Not found"
"903",573206,4411163,501,1460288896,40,70,"porn",110,30,"Not found"
"904",573217,4410962,501,734150016,36,79,"porn",115,43,"Not found"
"905",573220,4410949,501,1460288896,55,78,"porn",133,23,"Not found"
"906",573231,4410774,501,1022613248,27,84,"porn",111,57,"Not found"
"907",573256,4410358,501,72960753664,12,296,"porn",308,284,"Not found"
"908",573279,4410160,501,729053952,70,40,"porn",110,-30,"Barely Legal Little Runaways XXX DVDRip XviD "
"909",573286,4410067,501,1460288896,55,78,"porn",133,23,"Not found"
"910",573424,4408068,501,1471026304,92,66,"porn",158,-26,"Piece of Ass (2008) DvD - quality anal  porn"
"911",573432,4407946,501,727554432,234,76,"porn",310,-158,"Schoolgirl POV #3 (2008) XXX DVDRip"
"912",573448,4407703,501,1471026304,62,52,"porn",114,-10,"Not found"
"913",573455,4407582,501,734380672,62,92,"porn",154,30,"Not found"
"914",573597,4405585,501,733426496,37,65,"porn",102,28,"Not found"
"915",573599,4405525,506,864613824,45,60,"porn",105,15,"Not found"
"916",573619,4405187,501,1471026304,51,110,"porn",161,59,"Not found"
"917",573622,4405136,501,1460288896,63,87,"porn",150,24,"Not found"
"918",573667,4404529,599,748158976,43,71,"porn",114,28,"Not found"
"919",573860,4402042,501,1471026304,49,74,"porn",123,25,"Not found"
"920",573861,4402024,501,1471026304,51,86,"porn",137,35,"Not found"
"921",573879,4401769,501,1460288896,39,67,"porn",106,28,"Not found"
"922",573922,4401229,501,726275200,53,71,"porn",124,18,"Marc Dorcel - Hard Intrusion-French.DVDRIP"
"923",574028,4400138,501,733300672,56,93,"porn",149,37,"Not found"
"924",574067,4399593,501,1460288896,145,230,"porn",375,85,"Not found"
"925",574191,4398281,501,212818992,78,35,"porn",113,-43,"Bang Bros Porn - Little Tight Teen Gets Fucked Hardcore"
"926",574196,4398104,501,4649302016,101,403,"porn",504,302,"Nudist and Naturist Beach Girls Movies - Pack 03"
"927",574198,4398059,501,735251008,174,96,"porn",270,-78,"Marc Dorcel - Pornochic #16: Yasmine & Regina (2008) XXX DVDRip"
"928",574260,4397341,501,1460288896,52,80,"porn",132,28,"Not found"
"929",574389,4395772,501,1471026304,49,64,"porn",113,15,"Brazzers Presents : Teens Like It Big"
"930",574542,4393769,501,3682934528,44,223,"porn",267,179,"Not found"
"931",574553,4393610,506,19359565824,5,115,"porn",120,110,"Nubiles - C"
"932",574561,4393421,501,732335936,70,38,"porn",108,-32,"Not found"
"933",574568,4393335,501,1471026304,60,127,"porn",187,67,"Not found"
"934",574580,4393253,501,1471026304,71,135,"porn",206,64,"Not found"
"935",574583,4393161,501,1471026304,40,63,"porn",103,23,"Not found"
"936",574710,4391827,501,728372352,96,68,"porn",164,-28,"Not found"
"937",574712,4391805,501,1471026304,63,69,"porn",132,6,"Not found"
"938",574718,4391719,501,2931315200,73,214,"porn",287,141,"Not found"
"939",574807,4390724,501,1471026304,47,125,"porn",172,78,"Not found"
"940",574811,4390662,501,1471026304,43,85,"porn",128,42,"Not found"
"941",574891,4389648,501,1460288896,64,111,"porn",175,47,"Not found"
"942",575082,4387424,501,733111936,106,31,"porn",137,-75,"Little Lupe # 3 (2008) XXX DVDRip"
"943",575377,4385045,501,734988864,85,81,"porn",166,-4,"Marc Dorcel-Hardcore Models-French.DVDRIP"
"944",575468,4383940,599,247977744,53,99,"porn",152,46,"Not found"
"945",575590,4382715,506,4445291008,85,385,"porn",470,300,"Not found"
"946",575604,4382524,501,1460288896,40,81,"porn",121,41,"Not found"
"947",575613,4382433,501,1460288896,38,92,"porn",130,54,"Not found"
"948",575709,4381150,501,1017978560,88,207,"porn",295,119,"Not found"
"949",575743,4380729,501,1471026304,64,58,"porn",122,-6,"Not found"
"950",575824,4379911,501,1460288896,41,62,"porn",103,21,"Not found"
"951",575888,4379264,501,1471026304,49,66,"porn",115,17,"Not found"
"952",575907,4379037,501,16353087488,16,121,"porn",137,105,"Baby Got Boobs Part 1 PORN"
"953",575978,4377593,501,2931315200,30,121,"porn",151,91,"Not found"
"954",576073,4376548,501,733489408,79,139,"porn",218,60,"Not found"
"955",576103,4375738,501,740556800,28,90,"porn",118,62,"Not found"
"956",576218,4373974,501,1471026304,72,98,"porn",170,26,"Not found"
"957",576220,4373953,501,325425568,68,45,"porn",113,-23,"BangBros:Pornstars Like It Big - Alexis Texas"
"958",576227,4373827,501,1471026304,43,94,"porn",137,51,"Not found"
"959",576399,4371384,501,2190433280,39,67,"porn",106,28,"Not found"
"960",576532,4369549,501,39943196672,20,304,"porn",324,284,"Big.Tits.At.Shool.XXX.[SiteRip][GoldenPirates]"
"961",576550,4369119,506,86046144,119,10,"porn",129,-109,"Selection of unsuccessful doubles from pornofilms (32 mov)"
"962",576572,4368778,501,722594688,51,58,"porn",109,7,"Not found"
"963",576876,4364367,501,3650722304,41,78,"porn",119,37,"Not found"
"964",576887,4364273,501,888175360,1,174,"porn",175,173,"Taboo 1 (Full Version) Kay Parker.mpg"
"965",577083,4362007,501,1471026304,54,86,"porn",140,32,"GAY PORN-Eurocreme - Bareback Skate Mates  2007.avi"
"966",577293,4359295,501,4552665088,34,134,"porn",168,100,"Porno Collection Full DVD of Short Movies Hardcore XXX Pr0n Teen"
"967",577304,4359175,506,3768833792,34,104,"porn",138,70,"Not found"
"968",577751,4352954,501,1460288896,50,53,"porn",103,3,"Not found"
"969",577933,4350084,501,1460288896,38,92,"porn",130,54,"Not found"
"970",578256,4346434,506,564773504,46,71,"porn",117,25,"Not found"
"971",578372,4345219,501,732262592,53,61,"porn",114,8,"Not found"
"972",578448,4343984,505,7033009152,36,134,"porn",170,98,"Not found"
"973",578592,4342085,501,1471026304,65,184,"porn",249,119,"Not found"
"974",578601,4341951,506,18973018112,7,104,"porn",111,97,"Nubiles - A"
"975",578671,4340709,501,2942052608,70,279,"porn",349,209,"Not found"
"976",578715,4340192,501,2190433280,47,63,"porn",110,16,"Not found"
"977",578761,4339343,501,1460288896,40,71,"porn",111,31,"Not found"
"978",578833,4337781,501,1900523008,48,98,"porn",146,50,"GAY - [Falcon Studios] Romans Holiday - FVP 186.avi"
"979",578835,4337759,501,1471026304,86,231,"porn",317,145,"Not found"
"980",578867,4337336,506,3886945280,21,112,"porn",133,91,"Nord Video - Old & Young Lesbian Lust Clips Part2 ( Incest - Mat"
"981",578890,4337059,501,734433088,81,78,"porn",159,-3,"Not found"
"982",579047,4334553,501,1460288896,86,123,"porn",209,37,"Not found"
"983",579323,4329663,501,1471026304,56,75,"porn",131,19,"Not found"
"984",579397,4328320,501,733940288,81,70,"porn",151,-11,"Not found"
"985",579471,4326984,501,2190433280,68,79,"porn",147,11,"Not found"
"986",579495,4326815,501,1460288896,64,143,"porn",207,79,"Not found"
"987",579497,4326768,501,732503744,45,71,"porn",116,26,"Not found"
"988",579523,4326134,506,730846976,142,110,"porn",252,-32,"Not found"
"989",579623,4324621,506,730259776,90,91,"porn",181,1,"Not found"
"990",579747,4322527,501,3972844800,59,88,"porn",147,29,"Not found"
"991",579762,4322303,501,732765888,89,37,"porn",126,-52,"Private Xtreme 41: Addicted To Cock (2008) XXX DVDRip"
"992",580207,4314885,501,1224065664,71,68,"porn",139,-3,"Gay porn House of Bareback"
"993",580414,4310478,501,733615232,92,13,"porn",105,-79,"Tutto su Brigitta (2008) XXX DVDrip Must See"
"994",580490,4308313,501,1460288896,71,86,"porn",157,15,"Not found"
"995",580563,4307476,501,17459042304,26,253,"porn",279,227,"Not found"
"996",580587,4306932,501,305114656,92,26,"porn",118,-66,"Butt Frisk - Shyla Stylez (2008) XXX SATRip"
"997",580813,4302662,599,187013536,73,32,"porn",105,-41,"Not found"
"998",581097,4298057,501,728131200,128,106,"porn",234,-22,"Not found"
"999",581154,4296036,501,1267015296,70,122,"porn",192,52,"Not found"
"1000",581208,4294475,501,728980544,103,55,"porn",158,-48,"Dorcel Airlines: Paris-New York XXX (2008) DVDRip by [www.kiborg"
"1001",581687,4285461,599,55598350336,13,277,"porn",290,264,"Not found"
"1002",581747,4284355,501,734181440,620,340,"porn",960,-280,"Not found"
"1003",581850,4282750,501,23998130176,19,212,"porn",231,193,"Not found"
"1004",581990,4280503,505,67710160896,7,149,"porn",156,142,"Not found"
"1005",582062,4279038,501,318158944,93,17,"porn",110,-76,"Rachel Starr - XXX very nice ass DVDRip"
"1006",582074,4278668,501,4241280256,31,100,"porn",131,69,"Nudist and Naturist Beach Girls Movies - Pack 02"
"1007",582105,4278122,501,1471026304,40,73,"porn",113,33,"Not found"
"1008",582119,4277787,599,6582037504,36,155,"porn",191,119,"Sextape collection"
"1009",582196,4275781,501,756128128,44,67,"porn",111,23,"Not found"
"1010",582305,4273319,501,9803262976,12,178,"porn",190,166,"Not found"
"1011",582459,4270051,501,937919744,151,61,"porn",212,-90,"18 Year Old Pussy ? 7 -  XXX  - DVDRip"
"1012",582733,4266268,501,27444840448,28,288,"porn",316,260,"Not found"
"1013",583189,4257523,501,731790720,198,213,"porn",411,15,"Not found"
"1014",583230,4257083,501,733929792,18,90,"porn",108,72,"Not found"
"1015",583652,4250530,501,23869280256,13,123,"porn",136,110,"Moneytalks.com    Entire Site Rip!!!!    New!!"
"1016",584321,4237512,501,18532784128,8,95,"porn",103,87,"The VIP Crew (vipcrew.com) Entire Site RIP!!!!!"
"1017",584348,4237081,501,930611200,29,83,"porn",112,54,"Not found"
"1018",585097,4223993,506,467622944,96,20,"porn",116,-76,"[1CENT].Girls Gone Wild - Doggy Style-Hosted By Snoop Dogg.mpg"
"1019",586140,4207122,501,61579091968,6,166,"porn",172,160,"Site Rip [SapphicErotica.com] 01.01.2005-02.26.2007"
"1020",586884,4193837,506,896385664,84,73,"porn",157,-11,"BDSM - device bondage for females"
"1021",587862,4179992,501,2190433280,28,76,"porn",104,48,"Not found"
"1022",588607,4170651,506,43475808256,7,131,"porn",138,124,"Sasha Grey megapack"
"1023",588619,4170560,501,1471026304,38,107,"porn",145,69,"Lingerie.Shemale.Bedtime.Stories.2008.AMERiCAN.XXX.DVDRip.XviD"
"1024",589145,4162845,501,1460288896,30,72,"porn",102,42,"Not found"
"1025",589384,4159200,501,734338752,830,898,"porn",1728,68,"Not found"
"1026",589602,4155172,506,589844992,107,95,"porn",202,-12,"Classic Porno (1985) - Taboo 4 - The Younger Generation...FFF"
"1027",590181,4146720,501,1460288896,210,217,"porn",427,7,"Not found"
"1028",590225,4146014,506,44807245824,6,97,"porn",103,91,"StudentSexparties.com siterip ep1-21"
"1029",590227,4145880,501,3103113984,41,67,"porn",108,26,"Not found"
"1030",590269,4144798,501,13894218752,12,144,"porn",156,132,"DOG - beast pack vol.1 - RedAxeKiller"
"1031",590532,4139417,501,736708544,75,61,"porn",136,-14,"Amateurs casting for french porn movies"
"1032",590554,4139136,501,2791728640,33,97,"porn",130,64,"HORSE - beast pack vol.3 - RedAxeKiller"
"1033",590586,4138566,501,10522670080,15,126,"porn",141,111,"HORSE - beast pack vol.2 - RedAxeKiller"
"1034",590614,4137950,501,1460288896,355,572,"porn",927,217,"Not found"
"1035",590658,4136340,501,8557722112,22,144,"porn",166,122,"ZOOSKOOL - the beast pack - RedAxeKiller"
"1036",591089,4126077,503,15891379200,17,184,"porn",201,167,"Bandit64_Imagefap.com_Galleries"
"1037",591104,4125410,501,1460288896,363,542,"porn",905,179,"Not found"
"1038",591399,4119153,502,4745938944,26,75,"porn",101,49,"Virtual.Sex.With.Shay.Jordan.2007.XXX.COMPLETE.NTSC.DVDR-PLEASUR"
"1039",591555,4115377,501,735188096,77,81,"porn",158,4,"Lolitas Slaves No12 (Russian Teens).........FFF"
"1040",591713,4112221,506,31353262080,9,106,"porn",115,97,"Throated.com  **Megapack** 001 - 170"
"1041",592177,4104159,501,7473243136,15,140,"porn",155,125,"Dorcel - Russian Institute Anthology"
"1042",592451,4100218,501,1471026304,55,75,"porn",130,20,"Not found"
"1043",592601,4097471,506,9545565184,10,116,"porn",126,106,"YoungPorn.Net - 39 Pack (SiteRip)"
"1044",592623,4097008,501,732860224,94,43,"porn",137,-51,"Not found"
"1045",592660,4095797,501,1471026304,33,75,"porn",108,42,"Not found"
"1046",592687,4094664,501,109439880,1,127,"porn",128,126,"Total UK Porn Amatuers"
"1047",593187,4079636,501,1471026304,214,355,"porn",569,141,"Not found"
"1048",593371,4074698,501,737956352,104,87,"porn",191,-17,"Not found"
"1049",593482,4072657,503,2491080960,34,71,"porn",105,37,"jordan capri complete collection"
"1050",593556,4070523,501,731591488,521,527,"porn",1048,6,"Not found"
"1051",594091,4055376,501,731958464,331,396,"porn",727,65,"Not found"
"1052",594211,4052311,501,825418048,45,56,"porn",101,11,"Rape fantasy  (anal, DP) - Girl raped by 3 guys + other girl ! "
"1053",594236,4051811,501,733028032,60,47,"porn",107,-13,"Not found"
"1054",594401,4048368,505,14774687744,13,127,"porn",140,114,"Barely Legal 75th Anniversary Edition 2008 1080p XXX HD DVD VC-1"
"1055",594457,4047358,501,1471026304,69,100,"porn",169,31,"Banned! Asian Edition (2004, DVDrip.Xvid) "
"1056",594619,4044609,501,474417728,45,86,"porn",131,41,"Not found"
"1057",594797,4040336,501,734370176,477,596,"porn",1073,119,"Not found"
"1058",594960,4035773,501,734034688,265,151,"porn",416,-114,"Girls Gone Wild - Real, raw and totally uncensored"
"1059",595030,4034187,501,734191936,45,64,"porn",109,19,"Not found"
"1060",595132,4031919,501,726369536,139,140,"porn",279,1,"Marc Dorcel - Russian Institute: Lesson #7 [DVD.xvid] - anal,DP"
"1061",595333,4026797,501,3511135744,178,447,"porn",625,269,"Not found"
"1062",595455,4023212,501,17577154560,15,139,"porn",154,124,"Double Air Bags 1-22 Collection"
"1063",595648,4018116,501,1471026304,99,187,"porn",286,88,"My First Sex Teacher 12  XXX [DVDrip][Mature-All Sex]."
"1064",595659,4017987,501,733007040,482,507,"porn",989,25,"Not found"
"1065",595882,4011938,506,90408224,191,41,"porn",232,-150,"Not found"
"1066",596185,4005119,501,841188608,44,69,"porn",113,25,"Japanese Rape porn...............FFF"
"1067",596502,3999043,501,1460288896,253,414,"porn",667,161,"Not found"
"1068",596577,3997096,501,813516736,64,37,"porn",101,-27,"Not found"
"1069",596579,3997017,501,1471026304,35,68,"porn",103,33,"Not found"
"1070",596746,3992969,501,8096013312,33,110,"porn",143,77,"CUCKOLD - The ultimate collection - RedAxeKiller"
"1071",596747,3992964,501,28722593792,27,321,"porn",348,294,"SWINGERS - The ultimate collection - RedAxeKiller"
"1072",596826,3990400,501,1460288896,167,281,"porn",448,114,"Not found"
"1073",597012,3986327,501,2931315200,163,311,"porn",474,148,"Not found"
"1074",597136,3983896,501,1471026304,135,281,"porn",416,146,"Private Best Of 2007 XXX [DVDRIP][All Sex]."
"1075",597318,3976960,501,1471026304,88,127,"porn",215,39,"Private Lesbian Girl Girl Studio 4  XXX [DVDRip][Lesbian-Amateur"
"1076",597319,3976956,501,1471026304,35,77,"porn",112,42,"Knock Up My Mommy  XXX [DVDrip][Mature-All Sex]."
"1077",597545,3972172,501,717309888,61,78,"porn",139,17,"Videos amateurs 1 .rar"
"1078",597575,3971457,501,1288490240,292,288,"porn",580,-4,"Pirates (XXX) (2005).avi"
"1079",597627,3970539,501,10651518976,11,115,"porn",126,104,"Not found"
"1080",597628,3970535,501,10383083520,20,108,"porn",128,88,"Not found"
"1081",597629,3970447,501,10468982784,14,99,"porn",113,85,"Not found"
"1082",597876,3965683,506,196492656,113,49,"porn",162,-64,"Rape fantasy - 2 Korean young girls forced to have sex (uncensor"
"1083",597880,3965664,501,276404640,86,63,"porn",149,-23,"Rape fantasy - German girl "
"1084",597931,3964561,501,1471026304,75,147,"porn",222,72,"Private Black Label I Love Silvia Saint XXX [DVDRip][Pornstars]."
"1085",597944,3964237,501,3167538432,53,112,"porn",165,59,"Not found"
"1086",597946,3964209,501,2791728640,51,61,"porn",112,10,"Not found"
"1087",597955,3964182,501,716838016,55,75,"porn",130,20,"Real Female Orgasms 6 [15 Split Scenes of Screaming Orgasms]"
"1088",598073,3962172,501,50111528960,6,155,"porn",161,149,"Moms teaching teens.com-->entire site rip episodes 1-117  46GB"
"1089",598181,3960328,506,42026928,100,7,"porn",107,-93,"Not found"
"1090",598231,3959707,506,142155456,70,41,"porn",111,-29,"Son fuck his mom (Hot incest)"
"1091",598309,3958166,501,770441216,68,58,"porn",126,-10,"(Xxx Classic 1985) Sister Dearest (Traci Lords, Amber Lynn, Pete"
"1092",598394,3956344,501,808189952,61,83,"porn",144,22,"Color Climax - Incest Collection (11 Clips)"
"1093",598413,3956207,501,42498703360,7,139,"porn",146,132,"Not found"
"1094",598569,3952732,501,1438814080,168,161,"porn",329,-7,"Junior College Lesbians 2  XXX [DVDRip][Teen-Over-18-Lesbian].ww"
"1095",599252,3935405,501,4498978304,22,79,"porn",101,57,"Not found"
"1096",599526,3929033,506,7763153408,19,99,"porn",118,80,"New_And_Some_Old_Nude_Celebrity_Clips_-_High_Quality-2007-DJNilo"
"1097",599692,3925410,501,732765888,122,94,"porn",216,-28,"Mamasans The Asian MILF Movie  XXX [DVDRiP][Mature-Asian].loko"
"1098",599807,3922006,501,1460288896,35,68,"porn",103,33,"Desperate MILFs And Housewives 3 XXX [DVDRip][Mature-Amateur].ww"
"1099",599930,3919091,501,1460288896,32,72,"porn",104,40,"Mi vecina me la empina XXX "
"1100",599953,3918625,506,78160856,77,43,"porn",120,-34,"Homemade Sex Vdeo with 2 studentsi"
"1101",599966,3918234,501,1460288896,209,314,"porn",523,105,"Not found"
"1102",600257,3911439,501,1460288896,180,252,"porn",432,72,"Miss Big Ass Brazil 4 XXX [DVDRIP][Hardcore-Anal]"
"1103",600540,3904333,501,1471026304,50,144,"porn",194,94,"China Blue XXX [DVDRIP][Asian-Teens]"
"1104",600569,3903760,502,3629247488,55,104,"porn",159,49,"Girls Gone Wild (GGW) - 6 episodes"
"1105",600641,3901185,501,1460288896,93,123,"porn",216,30,"Barely Legal Christmas XXX [DVDRip][Legal Teens"
"1106",600745,3898544,505,13357347840,14,123,"porn",137,109,"Island Fever 4 1080p.hdtv.h264.DD5.1_???@www.2dmu.info"
"1107",600779,3897333,501,1460288896,59,98,"porn",157,39,"Double Bubble White Booty 2 XXX [DVDRIP][Anal-Interracial].www.l"
"1108",600780,3897331,501,731014784,84,92,"porn",176,8,"Dirty Sexy Momey (Lezley Zen) XXX [DVDRip][Mature]"
"1109",600799,3896653,501,56972742656,46,771,"porn",817,725,"Not found"
"1110",600895,3893576,501,733762048,203,425,"porn",628,222,"open season"
"1111",600984,3889840,501,8300024320,23,109,"porn",132,86,"Ass 2 Mouth 1-6 Collection"
"1112",601807,3875189,501,726442944,55,85,"porn",140,30,"Russian.Institute.Lesson.2."
"1113",601962,3872763,501,719574784,48,96,"porn",144,48,"Big Incest Family Group1"
"1114",602025,3871788,501,698792000,98,128,"porn",226,30,"Marc Dorcel - Incest Family Francais.........FFF"
"1115",602073,3871246,501,1309965056,42,124,"porn",166,82,"Maria Ozawa - Let's Have Sex At School [ONED-439]"
"1116",602082,3871182,501,737327168,55,66,"porn",121,11,"Marc Dorcel Infirmieres Et Petites Culottes (White-Hot Nurses 7)"
"1117",602398,3864424,506,208026992,197,77,"porn",274,-120,"50 Homemade Clips collection"
"1118",602401,3864355,501,732692480,91,94,"porn",185,3,"Not found"
"1119",602406,3864262,599,11156177920,22,87,"porn",109,65,"Not found"
"1120",602575,3860732,501,5025111552,34,155,"porn",189,121,"Crissy Moran ULTRA Pack"
"1121",602765,3856081,501,6055903744,21,91,"porn",112,70,"SoCal Coeds (New) - Complete Set!!"
"1122",602774,3855970,501,10651518976,54,434,"porn",488,380,"Bookworm Bitches - Complete Set!!"
"1123",602811,3854866,501,734328256,199,109,"porn",308,-90,"Not found"
"1124",603038,3849100,501,355823776,84,30,"porn",114,-54,"Party orgy: Girls going bananas 4 bananas"
"1125",603349,3843619,501,679110272,77,69,"porn",146,-8,"Max Hardcore Extreme Schoolgirls 1.............FFF"
"1126",603397,3842579,501,613888832,67,48,"porn",115,-19,"Not found"
"1127",604108,3830656,501,1793148800,77,129,"porn",206,52,"Not found"
"1128",604221,3828367,501,1460288896,58,102,"porn",160,44,"Not found"
"1129",604270,3827098,501,1460288896,43,78,"porn",121,35,"Not found"
"1130",604492,3822162,501,730846976,259,254,"porn",513,-5,"Not found"
"1131",604573,3819884,501,312978976,78,38,"porn",116,-40,"Not found"
"1132",604600,3819368,501,4359391744,24,94,"porn",118,70,"Gina Wild 1-7 Collection"
"1133",604632,3818497,501,727281856,132,107,"porn",239,-25,"Not found"
"1134",604831,3814510,501,659753536,149,69,"porn",218,-80,"Paris Hilton. One Night In Paris. DVDRip.XXX-AA"
"1135",604990,3811996,506,93470064,85,17,"porn",102,-68,"FTV Girls - Jenna Presley - Orgasm & Squirt"
"1136",605021,3811706,501,1471026304,83,168,"porn",251,85,"Not found"
"1137",605129,3809572,501,1460288896,35,66,"porn",101,31,"Not found"
"1138",605338,3806048,501,11370926080,31,217,"porn",248,186,"Not found"
"1139",605344,3805884,501,635478976,60,74,"porn",134,14,"Not found"
"1140",606906,3782142,501,77073186816,4,141,"porn",145,137,"The Hemtai collection"
"1141",607471,3771955,501,734118528,58,90,"porn",148,32,"Not found"
"1142",607781,3766914,501,32405528576,9,92,"porn",101,83,"Private castings"
"1143",609080,3751377,501,1535450752,35,82,"porn",117,47,"Russian Mature Incest 1-3"
"1144",609418,3748810,501,734108032,94,57,"porn",151,-37,"Best of Jenna Jameson[DVDrip][XXX].avi"
"1145",609672,3746800,501,1331439872,57,165,"porn",222,108,"[Movie Pack] Whorecraft - Episodes 1-6"
"1146",609830,3745768,501,19413252096,38,275,"porn",313,237,"The Best Of  Czech Public Invasion.com  - GIGA Pack"
"1147",610112,3743503,501,7376606208,14,88,"porn",102,74,"Ass Masterpiece - Complete Set!!"
"1148",612899,3709046,501,399025120,119,105,"porn",224,-14,"Amature Incest"
"1149",614435,3691584,501,733961280,111,104,"porn",215,-7,"Not found"
"1150",614766,3685841,599,733562816,76,104,"porn",180,28,"Russian 18s - (Hairy Young teen Russians).......FFF"
"1151",614955,3682394,501,55297703936,41,642,"porn",683,601,"Complete BangBus Rip - Episode 1 to 166 - PORNFINDER -"
"1152",617087,3645025,501,211025920,201,78,"porn",279,-123,"Kim Kardashian & Ray-J ** FULL Sex Tape **"
"1153",618378,3624870,599,719312640,84,83,"porn",167,-1,"Anal Lolitas (czech teens).....FFF"
"1154",618515,3621834,599,1374389504,47,127,"porn",174,80,"Celebrity.Nude.Clips.Part.10.of.10"
"1155",618517,3621804,599,1309965056,34,113,"porn",147,79,"Celebrity.Nude.Clips.Part.9.of.10"
"1156",618660,3620419,501,1267015296,38,70,"porn",108,32,"Classic XXX - #001 - Barbara the Barbarian - 1987"
"1157",618685,3620265,599,1069830656,43,103,"porn",146,60,"Celebrity.Nude.Clips.Part.8.of.10"
"1158",618744,3619512,599,984182976,39,109,"porn",148,70,"Celebrity.Nude.Clips.Part.7.of.10"
"1159",618862,3618381,506,1084479232,34,109,"porn",143,75,"Celebrity.Nude.Clips.Part.6.of.10"
"1160",619010,3616922,506,1073741824,49,115,"porn",164,66,"Celebrity.Nude.Clips.Part.5.of.10"
"1161",619130,3615260,506,1213328256,40,125,"porn",165,85,"Celebrity.Nude.Clips.Part.4.of.10"
"1162",619224,3614028,599,921425664,42,93,"porn",135,51,"Celebrity.Nude.Clips.Part.3.of.10"
"1163",619243,3613733,501,14935748608,11,95,"porn",106,84,"Shemale Samba Mania 11-20 Collector's Edition"
"1164",619267,3613423,599,1116691456,50,105,"porn",155,55,"Celebrity.Nude.Clips.Part.2.of.10"
"1165",619315,3612935,506,576014272,79,68,"porn",147,-11,"Celebrity Nude Clips Pak01 of 10"
"1166",620507,3591387,501,14817637376,10,108,"porn",118,98,"Shemale Samba Mania 01-10"
"1167",620803,3585942,501,56908316672,11,543,"porn",554,532,"Jenna.Jameson_Collection"
"1168",621137,3578203,501,7494717952,28,154,"porn",182,126,"Clara Morgane Anthology (almost)"
"1169",621468,3570372,501,1900523008,29,79,"porn",108,50,"Big Ass Shemale All Stars 3"
"1170",621632,3565907,501,5594194944,21,95,"porn",116,74,"Not found"
"1171",622843,3534324,501,40641126400,14,199,"porn",213,185,"NATURAL.WONDERS.OF.THE.WORLD.COMPLETE.COLLECTION"
"1172",623253,3524213,501,734506496,74,65,"porn",139,-9,"Kamasutra - Lovers.Guide.To.Sexual.Positions.DVDRip.XviD-SUG"
"1173",624125,3505552,501,818151424,57,48,"porn",105,-9,"Not found"
"1174",624455,3500827,501,1471026304,21,116,"porn",137,95,"Not found"
"1175",624681,3496163,501,4831838208,24,111,"porn",135,87,"Not found"
"1176",625031,3465988,501,13453984768,73,387,"porn",460,314,"Best Hentai Compilation"
"1177",625132,3464466,501,24223614976,13,125,"porn",138,112,"Private Gold-Pack5"
"1178",625725,3445235,501,849136832,96,62,"porn",158,-34,"Girls Gone Wild - Girls Who Like Girls (- DivX -) BYRDcutz"
"1179",626346,3429585,503,8750995456,16,108,"porn",124,92,"www.met-art.com - August 2005 Edition - High Quality Pics - Comp"
"1180",629713,3290536,501,21947283456,10,98,"porn",108,88,"fuckingmachines"
